1 ContributorNew Music Friday 10/08/21 LyricsDon Toliver - Flocky Flocky (feat. Travis Scott)
M√•neskin - MAMMAMIA
PinkPantheress - I must apologise
James Blake - Coming Back (feat. SZA)
Tainy - Lo Siento BB:/ (with Bad Bunny & Julieta Venegas)
Justin Bieber - Red Eye (feat. TroyBoi)
Mitski - Working for the Knife
bbno$ - yoga (feat. Rebecca Black)
Sleepy Hallow - Luv Em All
24kGoldn - Prada (feat. Lil Tecca)
Cordae - Super
Arca - Born Yesterday
brakence - argyle
Joyner Lucas - Late to the Party
Jesy Nelson - Boyz (feat. Nicki Minaj)
FLETCHER - girls girls girls
Why Don't We - Love Back
Julia Wolf - Nikes
Koffee - West Indies
Tyla Yaweh - Hands Up (feat. Morray)
347aidan - HARMONY
SEB - god of the sunsets
Ber - Meant To Be
Magdalena Bay - Hysterical Us
Masego - Garden Party
C. Tangana - Ateo
UPSAHL - Thriving
glaive - mental anguish
AJ Mitchell - Hi-Lo
Cody Johnson - Human üïí
Old Dominion - No Hard Feelings
COIN - Chapstick
Del Water Gap - I Hope You Understand
Abe Parker - 3 Moods
Marc E. Bassy - Future Love
Dillon Francis - Real Love
Martin Garrix - Diamonds
Young T & Bugsey - Big Bidness
Nas - Big Nas (Original Song from MasterClass)
Paris Texas - BULLSEYE
Sam Fender - Long Way Off
Tom Walker - Something Beautiful (feat. Masked Wolf)
Dave Gahan - Metal Heart
Bonobo - Rosewood
Lauren Jauregui - Colors
Kelis - Midnight Snacks
Yungeen Ace - Duffle Bag
Dustystaytrue - True To Me
POORSTACY - Jump
Ritt Momney - Sometime
Rxseboy - Bus Ride (feat. chloe moriondo)
Blake Rose - Rollerblades
Noah Gundersen - Atlantis
HONNE - BACK ON TOP (feat. Griff)
Dua Saleh - fav flav (with Duckwrth)
Keedron Bryant - Hello
Conway the Machine - Piano Love
Tech N9ne - Face Off
RINI - For Days
Matt Hansen - without you with me
Oh Wonder - Rollercoaster Baby
Porches - Back3School
Beau - Captivated
Mad Tsai - heartbreak honeymoon
aespa - Savage
Mick Jenkins - Contacts
Lute - Changes (feat. BJ The Chicago Kid)
Tank and The Bangas - Big
boylife - superpretty
Felly - Bones
Chase Rice - If I Were Rock & Roll üïí
Matt Maltese - We Need to Talk
Idman - Polytics
Jay Wheeler - BIOL-101
UNIIQU3 - What Chu Waiting For? üïí
ELIO - TYPECAST
CXLOE - Close
Alemeda - Gonna Bleach My Eyebrows
Pouya - Wig Split
Jeris Johnson - FRIDAY (feat. Trippie Redd)
LP - Angels
Nathaniel Rateliff - Pretty Good üïí
Natalie Hemby - It Takes One To Know One üïí
Abbey Cone - Rhinestone Ring
Alex Porat - miss sick world
LP Giobbi - O Retha
The Gray Havens - Summer Meets Winter üêö
Victor Internet - FEEL MYSELF
Just Stef - Liar Liar
Jesse McCartney - Lemonade
Manuel Turizo - Te Olvido
Ellery Bonham - Supermagic
Jordan Ward - Thrive
Willie Jones - Get Low, Get High
James Barker Band - New Old Trucks (feat. Dierks Bentley)
joan - so done
Bre Kennedy - Note To Self
Oberhofer - SUNSHiiNE (feat. Shamir, Nick Valensi)
KSHMR - Over You (feat. Lovespeake)
Kidd Keo - Corrido EspacialEmbed Something Beautiful (feat. Masked Wolf) Something Beautiful (feat. Masked Wolf) Tom Walker;Masked Wolf folk