2 ContributorsNew Music Friday 9/10/21 LyricsEd Sheeran - Shivers
Kacey Musgraves - simple times
Baby Keem - range brothers (with Kendrick Lamar)
J Balvin - Una Nota (feat. Sech)
Central Cee - Obsessed With You
LISA - LALISA
Glass Animals - I Don't Wanna Talk (I Just Wanna Dance)
Sam Hunt - 23
Fivio Foregin - Story Time
SZA - The Anonymous Ones
ChlÃ¶e - Have Mercy
DaBaby - Lonely (with Lil Wayne)
YoungBoy Never Broke Again - Life Support
Gryffin - Piece of Me (with LOVA)
girl in red - Stay: Spotify Singles
Troye Sivan - Angel Baby
Aaliyah - Rock The Boat
Tems - Crazy Tings
Lana Del Rey - Arcadia
Maxo Kream - Big Persona (feat. Tyler, ThÐµ Creator)
Alicia Keys - LALA (Unlocked) (fÐµat. Swae Lee)
Justus Bennetts - Bad Day
Mimi Webb - 24/5
Holly Humberstone - Scarlett
Deb Never - Funky
Nessa Barrett - keep me afraid
Remi Wolf - Guerrilla
Chelsea Cutler - Calling All Angels (with Quinn XCII)
Sabrina Carpenter - Skinny Dipping
G-Eazy - The Announcement
Yeat - Cmon
MUNA - Silk Chiffon (feat. Phoebe Bridgers)
Don Diablo - Stay Awake (feat. Freak Fantasique)
Sofia Reyes - Mal de Amores (feat. Becky G)
Ari Lennox - Pressure
Syd - Right Track (feat. Smino)
Masked Wolf - Pandemonium
Andy Grammer - Damn It Feels Good To Be Me
The Band CAMINO - Underneath My Skin
Eddie Vedder - Long Way
Joshua Henry - Awe of Her ðŸ•’
Yebba - All I Ever Wanted
Lorde - Te Amo MÃ£rama / Solar Power
Radiohead - If You Say the Word
á„‡á…¡á†¨á„’á…¨á„Œá…µá†« Park Hye Jin - Where Did I Go ðŸ•’
mxmtoon - in the darkness
kenzie - happy for me
Alan Walker - Running Out of Roses (feat. Jamie Miller)
R3HAB - Sad Boy (feat. Ava Max & Kylie Cantrall)
Rvssian - NostÃ¡lgico (feat. Rauw Alenjandro & Chris Brown)
RAY BLK - Over You (feat. Stefflon Don)
KYLE - Optimistic (feat. Dougie F)
KA$HDAMI - Public
Fresco Trey - Feel Good (feat. Lil Tjay)
Tay Money - The Assignment
PRETTYMUCH - I Don't Wanna Leave (feat. Jeremih)
Monsta X - One Day
Pia Mia - 730
Shallou - Heartaches
MarÃ­a Isabel - Back of My Mind
Alaina Castillo - lips
Lucie Silvas - We Don't Know We're Living (with Brandi Carlile & Joy Oladokun)
Cole Swindell - Some Habits
Mitchell Tenpenny - I Can't Love You Any More
Blake Rose - Movie
Cheat Codes - Ghost Story (with All Time Low)
Des Rocs - Hanging by a Thread
Ethan Tasch - GPS (with Felly)
Austin George - bluebonnetsðŸ•’
Spencer. - No Direction
Kevin George - Super Sweet
Common - Majesty (Where We Gonna Take It) (feat. PJ)
J. Rey Soul & will.i.am - PULL UP (feat. Nile Rodgers)
Austin Millz & Aluna - Gold
TELYKast - Unbreakable (with Sam Gray)
BoyWithUke - LoveSick
Alex Warren - Screaming Underwater
Eric Bellinger - Euphoric (feat. Brandy)
Mozzy - Straight to 4th
Duke Deuce - WTF!
Hotboy Wes - Free Smoke (feat. Big Scarr)
WizTheMC - Break
ceo@business.net - take a trip (feat. jungle bobby, bbno$ & lentra)
BAYLI - foreigner
FRENSHIP - All My Friends
Valerie Broussard - Drive
Jonathan Traylor - High Up
HIXTAPE - Hometown Boys (feat. Matt Stell, Dierks Bentley & HARDY)
Foy Vance - We Can't Be Tamed
Kate Bollinger - Shadows
ROSIE - Social Stamina
Boon - Somebody Else
EASHA - Manic Pixie Dream Girl
Elderbrook - I'll Find My Way To You (feat. Emmit Fenn)
Sleigh Bells - True Seekers
The Panturas - All I WantðŸ•’
Ann Marie - Favorite Love Song
Lil Mexico - Different Kind (feat. Pooh Shiesty)ðŸ•’
jamesjamesjames - Orange TeslaðŸ•’
BLANCO - Blu CelesteEmbed Feel Good (feat. Lil Tjay) Feel Good (feat. Lil Tjay) Fresco Trey;Lil Tjay sad