1 ContributorTop Male Artists of 2021 LyricsBad Bunny & Jhay Cortez - DÁKITI
Drake - Fair Trade (with Travis Scott)
Justin Bieber - Peaches (feat. Daniel Caesar & Giveon)
The Weeknd - Save Your Tears
J Balvin & Skrillex - In Da Getto
Juice WRLD - Come & Go (with Marshmello)
Rauw Alejandro - Cúrame
Ed Sheeran - Overpass Graffiti
Kanye West - Hurricane
Eminem - Lose Yourself (From "8 Mile" Soundtrack)
Myke Towers - Experimento
Travis Scott - SICKO MODE
Pop Smoke - Dior
Post Malone - Circles
The Kid LAROI - STAY (with Justin Bieber)
XXXTENTACTION - SAD!
Bruno Mars, Anderson .Paak & Silk Sonic - Smokin Out The Window
Ozuna, J Balvin & Chencho Corleone - Una Locura
Lil Nas X - INDUSTRY BABY (feat. Jack Harlow)
David Guetta - Memories (feat. Kid Cudi)
Polo G - RAPSTAR
DaBaby - BOP
Anuel AA & Bad Bunny - Hasta Que Dios Diga
Maluma - Hawái
Khalid - Better
Jhay Cortez & Anuel AA - Ley Seca
Lil Baby - Ready (feat. Gunna)
Daddy Yankee - MÉTELE AL PERREO
J. Cole - m y . l i f e (with 21 Savage & Morray)
Farruko - Pepas
Sech - 991
Harry Styles - Golden
Shawn Mendes - Wonder
Future - Life Is Good (feat. Drake)
Lil Uzi Vert - P2
Camilo - Millones
Marshmello & Bastille - Happier
Young Thug - Livin It Up (with Post Malone & A$AP Rocky)
Morgan Wallen - Wasted On You
Giveon - Heartbreak Anniversary
Kendrick Lamar - DNA.
Chris Bronw - No Guidance (feat. Drake)
Lil Peep & XXXTENTACION - Falling Down (Bonus Track)
Gunna & Future - Too Easy
21 Savage - a lot
Machine Gun Kelly - papercuts
Jack Harlow - I WANNA SEE SOME ASS (feat. jetsonmade)
Calvin Harris - By Your Side (feat. Tom Grennan)
Lil Tjay & 6LACK - Calling My Phone
Mac Miller - The SpinsEmbed Memories (feat. Kid Cudi) One More Love David Guetta;Kid Cudi edm