1 ContributorNew Music Friday 02/25/22 LyricsROSAL√çA - CHICKEN TERIYAKI
Kodak Black - Usain Boo
Mura Masa - bbycakes (with Lil Uzi Vert, PinkPantheress & Shygirl)
Coldplay - Day ‚Äòn‚Äô Nite - Spotify Singles
OneRepublic - West Coast
Jean Dawson - PORN ACTING*
Avril Lavigne - Bois Lie (feat. Machine Gun Kelly)
Doja Cat & Tyga - Freaky Deaky
Kygo - Dancing Feet (feat. DNCE)
Florence + The Machine - King
EARTHGANG - BILLI (feat. Future)
Rauw Alejandro - GRACIAS POR NADA
Bakar - Free
Alec Benjamin - Shadow Of Mine
Troye Sivan - Wait - from ‚ÄòThree Months‚Äô
Zach Bryan - From Austin
Lil Durk - AHHH HA
Flo Milli - PBC
Kehlani - little story
Becky Hill - Run
Araya - Pretty Lies üêö
Cavetown - Fall In Love With A Girl (feat. Beabadoobee)
Justus Bennetts - Don‚Äôt Trip (with GAYLE)
Central Cee - Straight Back to It
Swedish House Mafia - Redlight
Deb Never - Crutches
Lizzy McAlpine - reckless driving (feat. Ben Kessler)
Carter Faith - Greener Pasture
Nessa Barrett - dying on the inside
BabySantana - nyc
Ericdoa - fool4love
R3HAB - Put Your Hands On My ____ (feat. Saucy Santana) - Original Phonk Version
Joshua Bassett - Doppelg√§nger
Regina Spektor - Becoming All Alone
Joy Oladokun - Fortune Favors The Bold
Alicia Moffet - Hard Feelings
Maria Becerra - Felices x Siempre
JVKE - CHARGER
Salem ilese - PS5 (with TOMORROW X TOGETHER feat. Alan Walker)
JXN - Nintendo
22Gz - Possessed
Santa Fe Klan - √öltimo Adi√≥s
James Arthur - Lose My Mind (feat. Josh Franceschi)
Peter McPoland - Come Around
Ashley Kutcher - Love You More
Grace Ives - Loose
Sevdaliza - Everything Is Everything
Dreamer Isioma - Sunset Drive
Erica Banks - Slim Waist
Big Scarr - Fantasy (feat. Offset)
Mooski - Scuba Diving
Midwxst - i know you hate me
24kGoldn - Dawn to Dusk
Charlieonnafriday - Colorado Boulder
Lilyisthatyou - Moderation
BANKS - Holding Back
Mehro - like you‚Äôre god
Santangelo - Haptics
Denzel Curry - Zatoichi [Feat. slowthai]
Robert Glasper - Why We Speak [Feat. Q-Tip & Esperanza Spalding]
Jake Wesley Rogers - Dark Bird
Jillian Jacqueline - Magic
Jon Langston - Back Words
Blessing Offor - Believe
Sam Ryder - SPACE MAN
Fefe Dobson - FCKN IN LOVE
Jasiah - Earthquake (feat. jxdn)
Gang of Youths - spirit boy
Chloe Adams - Dead To Me
Rubi Rose - I Like
Tiana Major9 - 2 seater (feat. Smino)
Boyish - Congratulations
Josie Dunne - SORRY
Toro y Moi - The Loop
R√™ve - Layover
Isabel LaRosa - HAUNTED
Vf7 - Baila Bien
Yak Yola - Get Back (feat. G Herbo)
Jazz Cartier - Trust
Ero808 - RUNAWAY
Weston Estate - Sixty
Jensen McRae - Happy Girl
SASAMI - The Greatest
Otis Kane - Wanna Love You
Tauren Wells - Fake It
Drew Green - Good Ol' Man
Ace Hood - Greatness
Conway the Machine - Stressed
NMIXX - O.O
SIDEPIECE - Don‚Äôt Keep Me Waiting
Buppy. - Cold Nights In Hollywood
Chloe Lilac - last week
Ber - Same Effect
Teddy Robb - Get Away With It
Kat & Alex - I Want It All
Big Time Rush - Not Giving You Up
Karin Ann - almost 20
Brevin Kim - ALIENSPEAK (feat. Curtis Waters)
Kieran Ivy - Call Me Your Ex
Matilda Mann - Four Leaf DreamYou might also likeEmbed PS5 (with TOMORROW X TOGETHER & Alan Walker) PS5 (with TOMORROW X TOGETHER & Alan Walker) salem ilese;TOMORROW X TOGETHER;Alan Walker indie-pop