1 ContributorNew Music Friday 7/30/21 LyricsBillie Eilish - Happier Than Ever
Silk Sonic - Skate
Dermot Kennedy - Better Days
Isaiah Rashad - From The Garden (feat. Lil Uzi Vert)
The Kid LAROI - BEST FOR ME
Billie Eilish - Oxytocin
Bleachers - Secret Life (feat. Lana Del Rey)
Jhay Cortez - En Mi Cuarto
Terry Presume - Act Up
Logic - Theme For The People
Tyga - Mrs. Bubblegum
Sleepy Hallow - 2055 (feat. Coi Leray)
SEB - killer lover boy
Jelani Aryeh - A Piece Of Your Mind
Prentiss - hazel eyes
Billie Eilish - Billie Bossa Nova
G-Eazy - At Will (feat. EST Gee)
Skepta - Nirvana
Dan + Shay - Lying
Ant Clemons - Appreciation
Yung Fazo - Adding
Stunna Gambino - ZAZA
Toosii - spin music (feat. Fivio Foreign)
Parmalee - Only You
Don Diablo - Tears For Later
TOKiMONSTA - Naked üïí
Jungle - Truth
Mickey Guyton - Remember Her Name
Yola - Dancing Away In Tears
Jacquees - Not Jus Anybody (feat. Future)
Nicky Jam - Miami
Arizona Zervas - STILL BREATHING
Jackson Wang - Drive You Home
DallasK - Try Again (feat. Lauv)
Clean Bandit - Drive (feat. Wes Nelson)
glaive - bastard
Powfu - tinted green (feat. Mila Moon & Jomie)
Ryan Caraveo - Holly
X Ambassadors - Okay
Parker McCollum - Wait Outside
Dierks Bentley - Beers On Me
Tink - Rebel (feat. Jeremih)
Stove God Cooks - Run It Up
Scorey - Guardian Angel
Amindi - slideshow üïí
jamesjamesjames - It's Not You, It's Me - Club Mix
DJ Snake - You Are My High
WizTheMc - Everything
Au/Ra - Screw Feelings
UPSAHL - Time of my Life
Aidan Bissett - So High
Wrabel - back to back
Mark Ronson - Show Me üïí
Alok - In My Mind
M√ò - Kindness
Yebba - Louie Bag (feat. Smino)
Nao - And Then Life Was Beautiful
IV JAY - Vibrate (feat. Pink Sweat$)
Kash Doll - Like A Pro (feat. Juicy J)
Travis Thompson - Dead Prezis (feat. G-Eazy)
Young T & Bugsey - Prada Bae (feat. Nafe Smallz)
Gera MX - Se Me Olvid√≥
Brett Dennen - Paul Newman Daytona Rolex üêö
Ryan Hurd - Coast
NEEDTOBREATHE - I Am Yours
All Time Low - PMA (feat. Pale Waves)
contradash - Superficial
SAIAH - Cheater (feat. Tom The Mail Man)
Mild High Club - Me Myself and Dollar Hell
August Royals - Blue Football
Forrest Nolan - Hotel Room
Serena Isioma - Really, Really
Duckwrth - 4K
A1 x J1 - Baby (feat. Deno)
FISHER - Just Feels Tight
Aluna - Summer Of Love
Lost Frequencies - Where Are You Now
Jasmine Thompson - happy for you
ayokay - Better With You
Shalom Margaret - bro, i like u
Destiny Rogers - What I Like
JELEEL! - JELEEL JUICE!
Kalisway - Like That
Hotboy Wes - Soldier
Maxo Kream - Local Joker
9lokknine - Freeze Me üïí
Cameron Forbes - Send Nudes
Jany Green - Magic
Danny Ocean - Apartamento
L Devine - Priorities
PVRIS - Monster
Sleigh Bells - Locust Laced
Hillsong Young & Free - Freedom Is Coming - Live
Bri Steves - GAF (feat. Guapdad 4000)
Bktherula - Not Wock
Malachiii - Love Me
Jimi Somewhere - Headlights (feat. B√ºlow)
AHI - Danger
Angels & Airwaves - Losing My Mind
KID BRUNSWICK - Skin üïíEmbed Baby (feat. Deno) Baby (feat. Deno) A1 x J1;Deno chill