2 ContributorsNew Music Friday 12/24/21 LyricsNas - Wave Gods
Fireboy DML - Peru
Brett Eldredge - Holy Water
Gabrielle Aplin - Skylight
WALK THE MOON - Win Anyway
Kidd G - I Don't Wanna
DEKKO - 12x3
Lil Dicky - We Good (From The TV Show "DAVE")
Tay Money - Self Made
Money Man - Fans Go Crazy
Alok - Typical (feat. Lars Martin)
guardin - bad luck
juno - come thru
Lights - Real Thing (feat. Elohim)
Baauer - Love In The Music
DVBBS - Body Mind Soul (with Benny Benassi feat. Kyle Reynolds)
Jacob Collier - Fix You - Live for There With Care
Aiyana-Lee - Bedroom
Kid Ink - Hoe Games
Fredo Bang - Fool for Love
aespa - Dreams Come True
Klaas - Cross My Heart
Sipp–µr - psycho killa
Abe Parker - Rain For Christmas
Adam Turley - Circl–µs
Wifisfuneral - Save Me from Myself
SpotemGottem - On A Tee (feat. Icewear Vezzo)
Mixed Matches - bluemoon
han.irl <3 - @thenovo
tiffi - vivienne
Rayven Justice - On The Low (feat. Drenesse)
Big Boogie - Mixed Emotions
Ca$his - Higher Than I Eva...
Kaskade - How Long v3
Andrew Barth Feldman - Emma
Sophie Holohan - butterfly effect - demo
Wells* - I'm So Sad
Ethan P. Flynn - Superstition
Coyote Theory - Wishlist
BigKayBeezy - Middle Man
Chris Webby - Lord Knows (feat. Justin Clancy)
Sy Ari Da Kid - Christmas In The Hood
Jadu Jadu - never had a place
Daniel Blume - Better
Elsie Mae - Stop
Ashley Park - Mon Soleil - from "Emily in Paris" soundtrack
Kina Grannis - Gold
NEFFEX - Hustlin'
familypet - fake friends
Teqkoi - Too Late
Jperk - RIP
Nissim Black - Adored
Yana Bey - Nihilist
Bamily - Little Island
Anya Gupta - you ruined phoebe bridgers
Rose Cousins - Begin Again
Lucky Rose - Give You Up (feat. Mila Falls)
Rak-Su - Woman
Hurricane Wisdom - No Favors (feat. T9ine)
Azizi Gibson - That Ain't Nice
Yung Skrrt - Cinderace Weight
s0clich√© - Nutcracker
Michael Bibi - Soul System
Sharp Dialect - Shiny Toys
Joss Stone - Breaking Each Other's Hearts
Fay Wildhagen - promise,
North Mississippi Allstars - Didn‚Äôt We Have a Time
Passenger - Happy Christmas My Dear
Emily Muli - Break
Eva Shaw - 100GANG
Sav'o - Evil Intentions  üïí
Billy Marchiafava - BERRIS FUELLER
a4 - Dangerous
Zach Oliver - Feel Like Forever
Faime - Follow Me
S√©b Mont - Pieces
Nikonn - AddictedEmbed Body Mind Soul (with Benny Benassi feat. Kyle Reynolds) Body Mind Soul (with Benny Benassi feat. Kyle Reynolds) DVBBS;Benny Benassi;Kyle Reynolds progressive-house