3 ContributorsNew Music Friday 01/20/17 LyricsMaggie Rogers - On + Off
MUNA - Crying On The Bathroom Floor
Isaac Lee - U Make Me
Vanic - Too Soon ft. Maty Noyes
Nicky Jam - Without You
NoMBe - Wait
J. Cole - High For Hours
Watt - Burning Man ft. Post Malone
John Mayer - Changing
Joy Williams - Ordinary World
LANY - ILYSB
Train - Drink Up
Wale - Running Back ft. Lil Wayne
Alok & Liu - All I Want ft. Stonefox
Alina Baraz - Electric ft. Khalid
Spoon - Hot Thoughts
From First To Last - Make War
AFI - Hidden Knives
Kid Ink - In My Way ft. Mozzy, Bricc Baby and Nef The Pharaoh
Migos & Hoodrich Pablo Juan - I Can
Joey Bada$$ - Land of the Free
A R I Z O N A - Oceans Away (Sam Feldt Remix)
Phantoms - Someone to Talk About (Black Caviar Remix)
Big Sean - Halfway Off the Balcony
Migos - What the Price
3LAU & Said the Sky - Fire (Paris Blohm Remix) ft. NÉONHÈART
Sultan + Shepard - Cashmere Sweater ft. Brezy
Tunji Ige - Why Don't You?
Shy Girls - Watercolor Dreams
Frank Carter & The Rattlesnakes - Lullaby
Arcade Fire - I Give You Power ft. Mavis Staples
Ryan Adams - Doomsday
Lady Antebellum - You Look Good
Nikki Lane - Jackpot
Aaron Carter - Sooner or Later
Tayler Buono - Technically Single
Imad Royal - Smile
Jonathan Roy - Freeze Time
Dae Dae - Dem Days
Two-9 - Rackades ft. Curtis Williams, Key and Jace
FOREVER ANTI PoP - Finessin the Rhythm ft. David Sabastian
Rexx Life Raj - Sundaze / Devin's Song
Borgeous & tyDI - Over the Edge ft. Dia
Eden Prince - Toxic ft. Marco Foster
MiC LOWRY - Oh Lord (Swifta Beater Remix) ft. Sneakbo, Bossman Birdie, Tempa & Double S
Johnossi - Hands
Crystal Caines - Fuckery (Run With Me) ft. A$AP Ferg
Joshua Radin - Enough for You
Astronomyy - Don't Need U
Milo Greene - Afraid of Everything
Kevin Garrett - Stranglehold
Reo Cragun - It's Over
Heat - Cold Hard Morning Light
Starset - Telepathic
Foxygen - Follow the Leader
Rationale - Reciprocate
Pronoun - it's the way (live)
COTE - Cruel
Sofi Tukker - Johny
Dirty Projectors - Up In Hudson
Billy Porter - EdelweissEmbed The Way Echoes Of Life: Night Sultan + Shepard electronic