2 ContributorsWomen Of Soul LyricsEtta James - At Last
Nina Simone - Feeling Good
Aretha Franklin - Respect
Etta James - I'd Rather Go Blind
Linda Lyndell - What A Man
Dusty Springfield - Son of a Preacher Man
Aretha Franklin - I Say a Little Prayer
Jean Knight - Mr. Big Stuff
The Staple Singers - I'll Take You There
Betty Wright - Clean Up Woman
Roberta Flack - Killing Me Softly With His Song
Gladys Knight & The Pips - Midnight Train to Georgia
Patti LaBelle - Lady Marmalade
Minnie Riperton - Lovin' You
Shirley Brown - Woman To Woman
Gloria Gaynor - I Will Survive (Extended Version)
Joan Armatrading - Love And Affection
Diana Ross - I'm Coming Out
Patti LaBelle - If Only You Knew
Brenda Russell - Piano In The Dark
Chaka Khan - Ain't Nobody
Oleta Adams - Get Here
Whitney Houston - I Wanna Dance with Somebody (Who Loves Me)
Janet Jackson - That's The Way Love Goes
Vanessa Williams - Save The Best For Last
Neneh Cherry - Woman
Erykah Badu - On & On
Angie Stone - Brotha
Jill Scott - A Long Walk
Sade - Smooth Operator (Remastered)
India.Arie - Video
Norah Jones - Come Away With Me
Mary J. Blige - I'm Goin' Down
Faith Evans - You Used To Love Me
Kelly Price - Friend Of Mine
Ms. Lauryn Hill - Doo Wop (That Thing)
Alicia Keys - If I Ain't Got You
Keyshia Cole - Love
Heather Headley - In My Mind
Corinne Bailey Rae - Like A Star
Ledisi - Alright
Amy Winehouse - Valerie (Live At BBC Radio 1 Live Lounge, London / 2007)
Bettye LaVette - Things Have Changed (Radio Edit)
Esperanza Spalding - I Know You Know
Jennifer Hudson - Spotlight
Chrisette Michele - Epiphany (I'm Leaving)
Melanie Fiona - It Kills Me
Marsha Ambrosius - Far Away
Elle Varner - Only Wanna Give It To You (feat. J. Cole)
Kandace Springs - People Make The World Go 'Round
Alabama Shakes - Sound & Color
Janelle Mon√°e - Q.U.E.E.N. (feat. Erykah Badu)
Jazmine Sullivan - Let It Burn
Leela James - Set Me Free
Erykah Badu - Phone Down
The Internet - Girl (feat. KAYTRANADA)
Yuna - Crush (feat. Usher)
PJ - Gangster
Bibi Bourelly - Ego
Fantasia - Sleeping With The One I Love
Solange - Cranes in the Sky
Ari Lennox - GOATEmbed Valerie - Live At BBC Radio 1 Live Lounge, London / 2007 Back To Black (Deluxe Edition) Amy Winehouse british