1 ContributorNew Music Friday 5/21/21 LyricsOlivia Rodrigo - enough for you
Lil Nas X - SUN GOES DOWN
BTS - Butter
Polo Gâ€…-â€…GANG GANG (withâ€…Lil Wayne)
Zoe Wees - Hold Meâ€…Like You Used To
Anne-Marie - Our Song
Marshmello - Leave Before You Love Me (with Jonas Brothers)
City Girls - Twerkulator
42 Dugg - Maybach (feat. Future)
Olivia Rodrigo - happier
Lana Del Rey - Blue Banisters
Twenty One Pilots - Saturday
Lil Baby - We Win (Space Jam: A New Legacy) (and Kirk Franklin)
Pooh Shiesty - Switch it Up (feat. G Herbo, No More Heroes)
A Boogie Wit da Hoodie - 24 Hours (feat. Lil Durk)
SEB - seaside_dÐµmo
Julia Wolf - In My Way
Lucky Daye - Mercy Mercy MÐµ (The Ecology)
AUDREY NUNA - Top Again
Olivia Rodrigo - brutal
Galantis - Heartbreak Anthem (with David Guetta & Little Mix)
Vance Joy - Missing Piece
Zara Larsson - Morning
Holly Humberstone - The Walls Are Way Too Thin
Bleachers - Stop Making This Hurt
Dayglow - Medicine
Latto - The Biggest
Birdman - STUNNAMAN (with Roddy Ricch & feat. Lil Wayne)
FousheÃ© - enjoy the silence
salem ilese - Dinosaurs (S4E7)
Tai Verdes - i deserve 2 b alone
Anson Seabra - Magazines
MAY-A - Swing of Things
Patrick Droney - When The Lights Go Out
Lord Huron - Love Me Like You Used To
Blake Shelton - Body Language (feat. The Swon Brothers)
Duncan Laurence - Stars
Sinead Harnett - Anymore (feat. Lucky Daye)
Naliya - Handshakes
Oliver Malcolm - Runaway
binki - Clay Pigeon
Hayd - Airplane Mode
Japanese Breakfast - Savage Good Boy
Sharon Van Etten - Like I Used To
Masego - Yebo/Sema
Amorphous - Back Together
Rauw Alejandro - Todo De Ti
Lunay - VUDÃš
YG - Drop A Location
Young M.A - Don Diva
SpotemGottem - No Tik Tok
$uicideboy$ - Avalon
PawPaw Rod - Glass House
Mike Posner - Jealousy (feat. blackbear)
Carlie Hanson - Gucci Knife (feat. MASN)
Jade Bird - Different Kinds of Light
Teddy Swims - L.I.F.E.
Old Dominion - I Was On a Boat That Day
Ayron Jones - Supercharged
Green Day - Pollyanna
aldn - i'm alright
Smino - Rice & Gravy
Yung Baby Tate - Focused
Bobby Sessions - Gold Rolex (feat. Benny The Butcher & Freddie Gibbs)
Sada Baby - Little While (feat. Big Sean & Hit-Boy)
Young Nudy - Yellow Tape (feat. Lil Uzi Vert)
Money Man - Whole Lotta
88rising - Too Many Tears
Rezz - Taste of You (feat. Dove Cameron)
slenderbodies - mirror
Biig Piig - American Beauty
MARINA - Ancient Dreams In A Modern Land
NEEDTOBREATHE - I Wanna Remember (feat. Carrie Underwood)
Ross Copperman - Therapy
Jordan Davis - Buy Dirt
Brandy - Starting Now
Tobe Nwigwe - FYE FYE
FCG Heem - Need Dat Crack
Emilia - Perreito Salvaje
Armaan Malik - Echo (with KSHMR)
Qveen Herby - Naughty Girl
Justus Bennetts - Real Life Sux
Waterparks - Violet
Angels & Airwaves - Euphoria
JVKE - SECRETS
Bratty - lejos ðŸ•’
AleXa - Is It On
CLOVES - Screws
Allison Russell - 4th Day Prayer
Tenille Arts - Back Then, Right Now
Erika de Casier - Someone to Chill With
Tirzah - Sink In
Madison Ryann Ward - Emotions
DVBBS - Lose My Mind
Duke Dumont - Alter Ego
Bktherula - Santanny
Los Plebes del Rancho de Ariel Camacho - Hablemos
Mat Kearney - I Don't Really Care
San Holo - youâ€™ve changed, iâ€™ve changedEmbed Leave Before You Love Me (with Jonas Brothers) Leave Before You Love Me Marshmello;Jonas Brothers electro