2 ContributorsNew Music Friday 06/28/19 LyricsEd Sheeran - Beautiful People (feat. Khalid)
Daniel Caesar - LOVE AGAIN
Chris Brown - Don't Check On Me (feat. Justin Bieber & Ink)
The Black Keys - Walk Across The Water
Ellie Goulding - Hate Me (with Juice WRLD)
J Balvin - QUE PRETENDES
Mustard - Ballin' (feat. Roddy Ricch)
Rich Brian - Yellow (feat. Bekon)
mxmtoon - high & dry
Kygo - Higher Love
H.E.R. - Racks (feat. YBN Cordae)
Daniel Caesar - SUPERPOSITION
Julia Michaels - Hurt Again
BENEE - Glitter
Marshmello - Room to Fall
Carnage - Wait For Me (feat. G-Eazy & Wiz Khalifa)
Delacey - The Subway Song
Grace VanderWaal - Ur So Beautiful
Joyner Lucas - Broke and Stupid
BTS - Heartbeat (BTS World Original Soundtrack)
NF - When I Grow Up
Clairo - Closer To You
Conan Gray - Checkmate
Evie Irie - Bitter
Red Hearse - Red Hearse
Vampire Weekend - I'm Goin' Down - Recorded at Electric Lady Studios NYC
Annie Hamilton - Kitchen
serpentwithfeet - Receipts (feat. Ty Dolla $ign)
Daniel Caesar - FRONTAL LOBE MUZIK
Chris Brown - Need A Stack
Freddie Gibbs - Palmolive feat. Pusha T. & Killer Mike (feat. Pusha T & Killer Mike)
Daddy Yankee - Si Supieras
J Balvin - LA CANCIÓN
G-Eazy - Spectacular Now
Céline Dion - Flying On My Own
Why Don't We - Come To Brazil
Andy Grammer - Some Girl
Ingrid Michaelson - Young and in Love
Leah Kate - Girl on Girl
Chris Lane - Big, Big Plans
Brittany Howard - History Repeats
Thom Yorke - I Am a Very Rude Person
Lucy Dacus - Forever Half Mast
Liam Gallagher - The River
Juicy J - Three Point Stance (feat. City Girls & Megan Thee Stallion)
Rich The Kid - Party Bus
Fat Joe - Pullin
Phora - Forgive Me
Neck Deep - She's A God
Bring Me The Horizon - mother tongue - Recorded at Spotify Studios NYC
Furious Monkey House - Echoes
Sasha Sloan - Dancing With Your Ghost
Tori Kelly - Sorry Would Go A Long Way
Yuna - Pink Youth
Trixxie - All Of My Life
CNCO - De Cero
Big K.R.I.T. - Addiction (feat. Lil Wayne & Saweetie)
Mez - Upset
A$AP Ferg - Wigs (feat. City Girls & ANTHA)
Lil Yachty - Go Krazy, Go Stupid Freestyle
Bhad Bhabie - Get Like Me (feat. NLE Choppa)
Kevin Gates - Push It
Baby Rose - All To Myself
Marlhy - Claustrophobic
Adam Lambert - Comin In Hot
Kassi Ashton - Field Party
JP Saxe - Same Room
Meghan Trainor - Hurt Me - From "Songland"
Johnta Austin - Love Angel
Ty James - Heartbreak City
Slushii - Far Away
Caravan Palace - Plume
ayokay - Things Fall Apart
Boston Bun - Don't Wanna Dance
Alok - The Wall
K.Flay - Not In California
Silverstein - Burn It Down
Korn - You'll Never Find Me
Jeremy Renner - Heaven Don't Have a Name
Digital Farm Animals - Without You Now (feat. AJ Mitchell)
Kim Petras - Icy
Wifisfuneral - WYA, Pt. 2
Landon Cube - 17
RIZ LA VIE - Saturn
Michael Brun - Eda
Conor Maynard - Hate How Much I Love You
Stanaj - Love Me
Gigi Cesare - Obsessed
Felix Jaehn - Love On Myself
Global Dan - Runaway
Runaway June - We Were Rich
Josie Dunne - Ooh La La
Njomza - No One Is Spared
Frawley - Losers
Isle Of You - Hard to Forget
Ajani Jones - Lucid
Zero - Aim Steady
Jaydayoungan - Dead Man Walking
Foley - Can't Help the WayEmbed Hate Me (with Juice WRLD) Hate Me (with Juice WRLD) Ellie Goulding;Juice WRLD indie-pop