1 ContributorNew Music Friday 10/23/20 Lyricspositions - Ariana Grande
SO DONE - The Kid LAROI
Spicy (feat. Post Malone) - Ty Dolla $ign
Damage - H.E.R.
Back to the Streets (feat. Jhen√© Aiko) - Saweetie
BICHOTA - KAROL G
Triple Double - Jean Dawson
Too Much (feat. Usher) - Marshmello
Inside Out (feat. Griff) - Zedd
Forever After All - Luke Combs
distance - Ruel
Tyler Herro - Jack Harlow
Tonight (feat. iann dior) - jxdn
Can't Wait To Be Dead - FINNEAS
alive - ROLE MODEL
Gleesh Place - King Von
Don't Like Me (feat. Gucci Mane & Don Toliver) - Rico Nasty
Halloweenie III: Seven Days - Ashnikko
Green Eyes - Arlo Parks
making bad decisions - Bea Miller
Other Side - Khamari
The Power Of Prayer - Bruce Springsteen
Hell and High Water (feat. Alessia Cara) - Major Lazer
Paper Thin - ILLENIUM
Teardrops - Bring Me The Horizon
Lil Bit - Nelly
Sweet Melody - Little Mix
dominique - Ela Minus
Easy - Babygirl
Wish Me Luck - Wallows
wachito rico - boy pablo
ACTING NORMAL - BLACKSTARKIDS
Pride (feat. mxmtoon) - Noah Kahan
Only Fan. (with Jacquees) - Kiana Led√©
Why Not? - LOONA
Messed Up - Verzache
Affection - Fiji Blue
Free Like Me - Marc E. Bassy
On and On - THEY.
Cupid's Curse (feat. Kehlani) - Phora
556 - Comethazine
Snitch - Joyner Lucas
Back (feat. Yo Gotti) - Jeezy
We're All Gonna Be Killed - Terrell Hines
Her - Brandon
Reloj - Rauw Alejandro
The Valley of The Pagans (feat. Beck) - Gorillaz
Plenty - Gabrielle Current
Cool Girl - dodie
zombie girl - Adrianne Lenker
Oh No - Biig Piig
All On Me (feat. Zhu) - Tchami
Met In LA - Toosii
Chrome Heart Lens - Lil Tracy
Demons - StaySolidRocky
High & Dry - VanJess
Don't - GRACEY
Please Don't Make Me Fall in Love - Meg DeAngelis
Fires (feat. Lil West) - Carlie Hanson
No Ceiling (feat. Gunna) - DeJ Loaf
For Me - CHASE B
Don't Cry - MorMor
I Feel Like Shit - X Lovers
Change Your Mind - Miloe
Forgetting You - Cam
i see america - Joy Oladokun
Can You Afford to Be An Individual? - Nothing But Thieves
Head Up High - FITZ
Perfect Time - Luh Kel
Sexual (feat. Chris Brown) - Dave East
Brat (feat. Mulatto) - Tay Money
[Money Mouth -DJ Sliink]()
Self Destruct - Slayyyter
Hydrochloride - Ghostemane
Dead - CLOVES
Magic in the Madness - Lindsey Lomis
Faith Healer - Julien Baker
GREYGOOSE - Dounia
Grave - Leah Kate
I Can't - NoCap
No No No (feat. A Boogie Wit Da Hoodie) - Flipp Dinero
Wrong Side of Love (with Darius Rucker) - Young Bombs
Follow Me (Zoey 101) - Jamie Lynn Spears
Canceled - Larray
Adelaide - Johnny Orlando
Neighborhood - Miles Wesley
Sort It Out - COIN
Movie - Jutes
B.Y.S. - keshi
Numb & Nervous (feat. gnash) - Alec King
Aggy - Jackboy
Tennis - Blacc Zacc
The Devil Made Me Do It - B.o.B
Greyhound - Ashton Irwin
this is love - Walk Off the Earth
Lighter (with Tarrus Riley & Rvssian) - Shenseea
[100 Flows - Sally Sossa] üêö
The Blessing - Live - Kari Jobe
[Grammy - Jenn Morel]()

Choose a Side - MindchatterEmbed Spicy (feat. Post Malone) Featuring Ty Dolla $ign Ty Dolla $ign;Post Malone soul