2 Contributors23:55 LyricsYou Want Me - Tom Zanetti
If I Can't Have You - Shawn Mendes
Vossi Bop - Stormzy
Piece of Your Heart - Meduza
I Can't Get Enough - Benny Blanco, Selena Gomez, J Balvin
Boasty - Wiley, Stefflon Don
Wake Me Up Before You Go-Go - Wham!
Please Me - Cardi B, Bruno Mars
Giant - Calvin Harris, Rag N' Bone Man
Options - NSG, Tion Wayne
The Greatest Show - Hugh Jackman
Love Me Back - RITUAL
For You - Liam Payne and Rita Ora
Nights Like This - Kehlani, Ty Dolly $ign
Don't Call Me Up - Mabel
break up with your girlfriend, I'm bored - Ariana Grande
Keanu Reeves - Logic
Going Bad - Meek Mill, Drake
Wow. - Post Malone
7 rings - Ariana Grande
Dancing With A Stranger - Sam Smith,Normani
Love me Back - RITUAL, Ty Dolly $ign
No Stylist - French Montana
Funky Friday - Dave, Fredo
This Feeling - The Chainsmokers, Kelsea Ballerini
Polaroid - Jonas Blue, Liam Payne and Lennon Stella
I Found You - benny blanco, Calvin Harris
I Love - Joyner Lucas
Taki Taki - Selena Gomez, DJ Snake, Cardi B
MIA - Drake, Bad Bunny
The Way I Am - Charlie Puth
Lost in Japan - Remix - Shawn Mendes, ZEDD
Drop - G Eazy
First Time - Liam Payne, French Montana
REMEDY - Alesso
Celoso - Lele Pons
She Knows How To Love Me - David Guetta
REEL IT IN - Amin√©
Electricity - Silk City, Dualists Lipa
Cool - Felix Jaehn
Lucky You - Eminem, Joyner Lucas
Boca Raton - bas, A$AP Fergy
V. 3005 - Childish Gambino
Rockstar - N.E.R.D.
SICKO MODE - Travis Scott
Rise - Jonas Blue
FAKE LOVE - BTS
Eastside - Halsey, Khalid
Promises - Calvin Harris, Sam Smith
In My Feelings - Drake
Nonstop - Drake
WORKN ME - quavo
Better Now - post Malone
rockstar - Post Malone
No Problem - Chance The Rapper, 21 savage
Still Got Time - ZAYN
Magnolia - Playboy Carti
Body - Loud Luxury, Brando
you should see me in a crown - Billie Eilish
Drew Berrymore - Bryce Vine
Swish - Tyga
APESH*T - The Carters
Just Hold On - Louis Tomlinson
Youngblood - 5 Seconds Of Summer
Greatest - EminemEmbed This Feeling Sick Boy The Chainsmokers;Kelsea Ballerini edm