3 ContributorsNew Music Friday 07/12/19 LyricsEd Sheeran - South of the Border (feat. Camila Cabello & Cardi B)
Ed Sheeran - Antisocial (with Travis Scott)
Ed Sheeran - Remember The Name (feat. Eminem & 50 Cent)
Billie Eilish - bad guy (with Justin Bieber)
French Montana - Wiggle It (feat. City Girls)
David Guetta - Thing For You (With Martin Solveig)
Beyoncé - Spirit - From Disney's "The Lion King"
Future - 100 Shooters (feat. Meek Mill & Doe Boy)
Kane Brown - Like a Rodeo
Blood Orange - Dark & Handsome
Bon Iver - Faith
Lil Nas X - Old Town Road (feat. Young Thug & Mason Ramsey) - Remix
NF - Time
K.Flay - Good News
dvsn - Miss Me?
Big K.R.I.T. - Prove It (feat. J. Cole)
Tory Lanez - Melee
Steve Aoki - Crash Into Me
R.LUM.R - How This Feels
Ann Marie - Throw It Back
BANKS - Contaminated
Jax Jones - Harder
Beyoncé - Can You Feel the Love Tonight
Madeon - Dream Dream Dream
Yuna - Likes
Deaton Chris Anthony - Sonshine
Sabrina Carpenter - I’m Fakin
Nas - Jarreau Of Rap (Skatt Attack)
Becky G - DOLLAR
Tycho - Weather
Kash Doll - Ready Set (feat. Big Sean)
Joyner Lucas - 10 Bands
Wale - On Chill (feat. Jeremih)
Lil Durk - Like That (feat. King Von)
Cousin Stizz - Perfect (feat. City Girls)
Ozuna & Anitta - Muito Calor
Phora - On My Way
Of Monsters and Men - Wild Roses
Benjamin Gibbard - Keep Yourself Warm
Isaac Dunbar - ferrari
Alexander 23 - Sad
Sofi Tukker - Swing
Armin van Buuren - Something Real
Loud Luxury - I'm Not Alright
RITUAL - Using (with Emily Warren)
Yellow Claw - Get Up
Benjamin Ingrosso - Costa Rica
Nora En Pure - Heart Beating
GNAR - Octane Sex
PVRIS - Death of Me
Pretty Vicious - Something Worthwhile
Chris Young - Town Ain't Big Enough
Kenny Chesney - Tip of My Tongue
Sheryl Crow - Everything Is Broken
Andy Grammer - I Found You
AJ Mitchell - Move On
Ra Ra Riot - War & Famine
Matt Corby - Talk It Out
BONES UK - Beautiful Is Boring
Gallant - Crimes
DOPE LEMON - Give Me Honey
Justin Love - Get Out
The Bonfyre - U Say (feat. 6LACK)
RJMrLA - Time (feat. Young Thug)
Deux Twins - What’s the Move
Maya B - Getty Woah
Filmore - Other Girl
Jeremy Renner - Main Attraction
Mike Posner - Look What I've Become
Black Milk - If U Say (feat. BJ The Chicago Kid)
Rexx Life Raj - Rich (feat. ALLBLACK)
Baby Keem - France Freestyle
Nef The Pharaoh - High Voltage (feat. Tyga)
Ronny J - Lights Out (feat. Ty Dolla $ign & Rich The Kid)
Lil West - Bad
Common - Hercules [Feat. Swizz Beatz]
GOLDHOUSE - Cardio
Deorro - All This Time
Guapdad 4000 - Scammin
Yellow Days - It's Real Love
QUIX - Life Long After Death (feat. badXchannels)
Lower Dens - I Drive
Christian French - hungover sunday
Tobi Lou - My Party
Phantoms - Say It
Project Pat - CheezNDope (feat. Young Dolph & Key Glock)
Elle Varner - Pour Me (Thinkin bout u) [feat. Wale]
Gavin Haley - Show Me
In Real Life - Hurt for Long
Levi Hummon - Drop of Us
CLEWS - Hollywood
Asking Alexandria - The Violence
Rauw Alejandro - Detective
Eve - Reload (feat. Konshens)
Jay Som - Tenderness
The Band Perry - THE GOOD LIFE
Sam DeRosa - Baby I Know
KSHMR - My Best Life (feat. Mike Waters)Embed High Enough - RAC Remix High Enough (RAC Remix) K.Flay;RAC electro