1 ContributorNew Music Friday 02/11/22 LyricsPusha T - Diet Coke
Nicki Minaj - Bussin
Saweetie - Closer (feat. H.E.R.)
Ed Sheeran - The Joker And The Queen (feat. Taylor Swift)
ODESZA - The Last Goodbye (feat. Bettye LaVette)
Future - Worst Day
Kodak Black - Grinding All Season
Omar Apollo - Invincible (feat. Daniel Caesar)
Jazmine Sullivan - Roster
Fivio Foreign - City of Gods
$NOT - ALONE (feat. Trippie Redd)
Doja Cat - Celebrity Skin
Becky G - MAMIII
Dove Cameron - Boyfriend
Caroline Polachek - Billions
Internet Money - Options (feat. 24kGoldn)
Yeat - Still Countin
Diplo - Don't Forget My Love
Alexander 23 - Hate Me If It Helps
Matilda Cole - Again
Maren Morris - Background Music
Mary J. Blige - Here With Me (feat. Anderson .Paak)
Rauw Alejandro - Caprichoso
Fred again.. - Admit It (U Don‚Äôt Want 2)
Jung Kook - Stay Alive (Prod. SUGA of BTS)
Alt-J - The Actor
Eddie Vedder - Invincible
Mozzy - Real Ones (feat. Roddy Ricch)
Rema - Calm Down
Cautious Clay - 25/8
Claire Rosinkranz - i h8 that i still feel bad for u
Dustin Lynch - Party Mode
Orville Peck - C'mon Baby, Cry
Portugal. The Man - What, Me Worry?
Felix Cartal - Nothing Good Comes Easy
KayCyy - OKAY! (Prod. Gesaffelstein)
Kim Petras - Treat Me Like A Slut
L√òL√ò - debbie downer
Jack White - Fear Of The Dawn
Mxmtoon - mona lisa
Vance Joy - Don't Fade
The Head And The Heart - Virginia (Wind In The Night)
Sof√≠a Reyes - Marte
Kali - UonU (feat. Yung Bleu)
Fresco Trey - Need You
Snoop Dogg - Coming Back
Central Cee - Khabib
Said The Sky - Walk Me Home
Ayokay - Waiting For (with slenderbodies)
Jenna Raine - 2%
Thomas Rhett - Us Someday
Priscilla Block - Ever Since You Left
Big Thief - Red Moon
Father John Misty - Q4
Nina Nesbitt - When You Lose Someone
Bow Anderson - 20s
Raveena - Love Overgrown
Bree Runway - Pressure
Duke Deuce - Falling Off (feat. Rico Nasty)
Juicy J - Weak
Foals - 2am
Orion Sun - dirty dancer
Sharon Van Etten - Porta
Barrie - Jenny
Fana Hues - wild horses
Aiyana-Lee - Make You Love Me
LION BABE - Harder (with Busta Rhymes)
Wilkinson - Here For You
Wisin & Yandel - NO SE OLVIDA
Chase Matthew - Can‚Äôt Hide Love
Joe Nichols - I Got Friends That Do (feat. Blake Shelton)
LAUNDRY DAY - We Switched Bodies
Myd - The Sun (feat. JAWNY)
Aidan Bissett - Grocery Store Girl
Mckenna Grace - do all my friends hate me?
Victoria - closer (vol.1 ch.1)
Jonah Kagen - Drowning
Johan Lenox - I'm a Mess
Sada Baby - Perfect Form Skub üêö
Eli Derby - Love Song
Fran Vasiliƒá - Maybe
Ogi - I Got It
The Last Artful, Dodgr - Hullabaloo
Autumn! - Bentley Bentayga!
LIL DUSTY G - BELTANE
Bennytheghost - Say Something üïí
Half‚Ä¢alive - Move Me
Joywave - We Are All We Need
Spoon - My Babe
Blessing - girl like me
HoneyLuv - Your Tongue
Pardison Fontaine - Hoop Earrings
Junior H - Como Jordan
Adriel Favela - Botecito A Pecho
Alex Vaughn - Mirage
Anna Shoemaker - Mariah
Amos Lee - Hold You
Shy High - clam chowder
Julius Black - Together We Go Down In The DarkYou might also likeEmbed The Last Goodbye (feat. Bettye LaVette) The Last Goodbye (feat. Bettye LaVette) ODESZA;Bettye LaVette chill