2 ContributorsNew Music Friday 2/19/21 LyricsAriana Grande - test drive
24kGoldn - 3, 2, 1
Trippie Redd - PILL BREAKER (feat. blackbear & Machine Gun Kelly)
Conan Gray - Overdrive
HAIM - Gasoline (feat. Taylor Swift)
Chris Brown - Go Crazy (Remix) (feat. Future, Lil Durk & Mulatto)
NF - CLOUDS - Edit
Alan Walker - Fake A Smile
Lil Yachty - Hit Bout It
Paris Texas - HEAVY METAL
SG Lewis - Fall
Alexander 23 - Come Here and Leave Me Alone
Still Woozy - Rocky
THE BLOSSOM - HARDCORE HAPPY
AJR - Way Less Sad
CJ - Goin’ UP
Luis Fonsi - Vacío
Tash Sultana - Blame It On Society
Clinton Kane - CHICKEN TENDIES
YAS - TUCKITIN
Kevin Gates - Puerto Rico Luv
LILHUDDY - The Eulogy of You and Me
Nessa Barrett - la di die (fеat. jxdn)
Mike Shinoda - Happy Endings (feat. iann dior and UPSAHL)
Mahalia - Jealous (fеat. Rico Nasty)
Brent Faiyaz - Eden - From “Black History Always / Music For the Movement Vol. 2"
Tainy - Sunbathe
MAY-A - Time I Love to Waste
Carly Pearce - 29
mehro - chance with you
Babygirl - You Were in My Dream Last Night
beaux - i've got a best friend
Lord Huron - Not Dead Yet
Paloma Mami - Religiosa
Russ - MISUNDERSTOOD
Kelly Rowland - Flowers
Justine Skye - Intruded
Genesis Owusu - Gold Chains
Kenny Mason - Partments
Wallows - Quarterback
Isaac Dunbar - fan behavior
daydream Masi - Can I Be The One?
DCG Shun - Rivals (feat. Calboy)
Cash Cash - Too Late (feat. Wiz Khalifa & Lukas Graham)
Syence - a little bit bored (feat. ruuth)
Sarah Proctor - The Breaks
Alfie Templeman - Everybody’s Gonna Love Somebody - Edit
Powfu - the way that you see me (feat. Ayleen Valentine)
nothing,nowhere. - buck
Marshmello - Lavandia
L.L.A.M.A - Shake (with Ne-Yo & Carmen DeLeon)
Young Dolph - Case Closed
MadeinTYO - HUNNIDDOLLA
Cochise - Usopp
Paul Woolford - HEAT
Purple Disco Machine - Fireworks (feat. Moss Kena & The Knocks)
Tayler Holder - 100 Rounds
Kina - I’m Not Going Back (feat. Mokita)
Amy Shark - Love Songs Ain't for Us (feat. Keith Urban)
Jon Caryl - House of Glass
Michl - Holidays
serpentwithfeet - Same Size Shoe
LightSkinKeisha - FDH
Big Ghost Ltd - Way We Move
Anoyd - If Not Now, When?🐚
Jemere Morgan - My Kingdom🐚
CHUNG HA - Demente (feat. Guaynaa)
PRETTYMUCH - Lonely
Ella Henderson - Let’s Go Home Together
Olivia Holt - Do You Miss Me
Tom Odell - numb
Sophia Messa - Not That Kind of Love
Sandro Cavazza - Love To Lose
vf7 - Codigo Secreto
OMB Peezy - Love Is Blind
Lil Zay Osama - Shooters (feat. Doe Boy) 🐚
Grip - Peaks N Pitfalls 🐚
Dawn Richard - Bussifame
Marzz - So Frequently 🐚
Amythyst Kiah - Black Myself
Manchester Orchestra - Bed Head
Yoshi Flower - Faking Sleep
dempsey hope - autumn
OSTON - Lie About You
KIDDO - My 100
Oliver Heldens - Never Look Back (feat. Syd Silvair)
Mikhala Jené - We Are The Promise🐚
Day Sulan - Bailar
BlueBucksClan - Horace Grant
TobyMac - Help Is On The Way (Maybe Midnight)
Lainey Wilson - Sayin' What I'm Thinkin'
Adam Melchor - Begin Again
Will Paquin - Now You Know
Ben Chandler - Let You Go
Rockie Fresh - Gucci 🐚
Big $tunt - Money Gang (feat. Pooh Shiesty) 🐚
KyleYouMadeThat - Hoopla
Dimitri Vegas & Like Mike - Too Much
Baby Storme - everybody knows
Oscar Scheller - Boys CryEmbed la di die (feat. jxdn) la di die (feat. jxdn) Nessa Barrett;jxdn electro