1 ContributorNew Music Friday 09/23/22 LyricsSam Smith - Unholy (feat. Kim Petras)
Lil Nas X - STAR WALKIN' (League of Legends Worlds Anthem)
Lewis Capaldi - drivers license - Spotify Singles
Kelsea Ballerini - MUSCLE MEMORY
CKay - mmadu
GloRilla & Cardi B - Tomorrow 2
Maya Hawke - Luna Moth
Khalid - Satellite
DaBaby - SOCKS☑️
Muni Long - Plot Twist
Moneybagg Yo - Blow
Q - Stereo Driver
Yung Gravy, bbno$ & Rich Brian - C'est La Vie
Stormzy - Mel Made Me Do It
Freddie Gibbs - Dark Hearted
Fred again.. - Bleu (better with time)☑️
The 1975 - All I Need To Hear
Wet Leg - Daisy - Spotify Singles
Kid Cudi & Ty Dolla $ign - Willing To Trust
FLO - Not My Job
5 Seconds of Summеr - Bad Omens
Quinn XCII – Common (feat. Big Sean)
iann dior - saddеst soundtrack
SG Lewis - Vibe Like This (feat. Ty Dolla $ign & Lucky Daye)
SiR - Nothing Even Matters
GIVĒON – Time
Joy Oladokun - Sweet Symphony (with Chris Stapleton)
JVKE - this is what sadness feels like
Polimá WestCoast & J Balvin - KAWAII
Jamie xx - KILL DEM🐚
YG - Maniac
Major Lazer, Major League Djz, & DJ Maphorisa - Koo Koo Fun (feat. Tiwa Savage)
Rauw Alejandro & Baby Rasta - PUNTO 40
Channel Tres - No Limit☑️
Alex G - Immunity
Ashe - Love Is Letting Go (feat. Diane Keaton)
Joshua Bassett - Lifeline
JP Saxe - When You Think Of Me
Shania Twain - Waking Up Dreaming
Maddie & Tae - Watching Love Leave
Protoje - Ten Cane Row
Lakeyah - Maneuver (feat. Flo Milli)
Gucci Mane, BiC Fizzle & BigWalkDog - Red Flag
Red Hot Chili Peppers - Eddie
Charlotte Lawrence - Morning
Mike Posner - I'm Not Dead Yet
Baby Tate - Ain’t No Love (feat. 2 Chainz) ☑️
Kordhell & Scarlxrd - MISS ME?
Kito - Sad Girl Music (feat. BANKS)
D-Block Europe - Lonely Lovers☑️
Tom The Mail Man - •YOU’RE THE ONE I LIKE NOW•
The Smashing Pumpkins - Beguiled
Emotional Oranges - Cardigan
Carin Leon - Si Es Cierto Que Te Vas🐚
Christian Leave - Why Not? 🐚
BLACKSTARKIDS - DIGITAL WORLD 🐚
Izzi De-Rosa - love u in the morning
Shallou - Save Some Room 🐚
MEDUZA - Under Pressure 🐚
Toosii - Heartaches
LUCKI - KAPITOL DENIM
Crush - Rush Hour (Feat. j-hope of BTS)
Jnr Choi - TICK TOCK
Savannah Ré - WTF☑️
Zoe Wees - Daddy's Eyes
Zolita - 20 Questions
Nate Smith - I Found You
Milky Chance - Troubled Man
Weezer - What Happens After You?
JELEEL! - DELIVER!
DreamDoll - Fantasy 🐚
Kailee Morgue - Queen Bitch
Monét Ngo - Bleachers 🐚
Alvvays - Belinda Says
TOLEDO - How It Ends 🐚
Yellow Days - Inner Peace 🐚
Nikki Lane - Denim & Diamonds 🐚
Elaine - Deja Vu
Kany García & Christian Nodal- La Siguiente
Aya Nakamura - VIP
Ofenbach - Love Me Now 🐚 (feat. FAST BOY)
Sam Tompkins - Lose It All
PIAO - Haunted by Potential 🐚
Allie Paige - i feel like flying☑️
Greyson Chance - My Dying Spirit
SLANDER - Nothing Hurts Like Goodbye (Feat. Kiiara)
Cam’Ron & A-Trak - What You Do 🐚
Fabolous & Dave East - BACH TO BACH
Kendell Marvel - Come on Sunshine 🐚
Gunnar Gehl - Cinnamon 🐚
Magdalena Bay - Unconditional
Vieux Farka Touré & Khruangbin - Diarabi 🐚
Izzy Spears - BAD NEWS 🐚
NMIXX - DICE
TSHA - Running 🐚
Tamino - Sunflower
re6ce - teeth (you)
Ocean x KungFu - M.A.B 🐚
Bellah - Garden 🐚
Georgia Webster - X's 🐚Embed Common (with Big Sean) Common Quinn XCII;Big Sean indie-pop