1 ContributorNew Music Friday 02/18/22 LyricsJack Harlow - Nail Tech
Kid Cudi - Want It Bad (with Nigo)
Mimi Webb - House On Fire
Oliver Tree - Swing & A Miss
Gunna - Banking On Me
Vince Staples - MAGIC (feat. Mustard)
Tame Impala - The Boat I Row
Jessie Murph - Pray
Yeat - Outsid√´ (feat. Young Thug)
Stefflon Don - Like That
Lucky Daye - NWA (feat. Lil Durk)
Silk Sonic - Love's Train
Rex Orange County - AMAZING
Troye Sivan - Trouble
Maude Latour - Headphones
ROLE MODEL - if jesus saves, she's my type
J Balvin - Ni√±o So√±ador
Shenseea - R U That (feat. 21 Savage)
RealestK - Love Me
Ed Sheeran - Bad Habits (feat. Bring Me The Horizon)
Benson Boon–µ - ROOM FOR 2
Sabrina Carpenter - Fast Times
347aidan - BAD KIDS
Khruangbin - Mari–µlla
Mike Dimes - HOME
DDG - Elon Musk (feat. Gunna)
Baby Tate - What's Love
Danny Ocean - Fuera del mercado
Clean Bandit - Everything But You (feat. A7S)
Alemeda - Post Nut Clarity
Ty Dolla $ign - Champions (feat. Wiz Khalifa)
SAINt JHN - For The Squadron
Tinashe - Naturally
Tessa Violet - YES MOM
Sara Kays - When You Look At Me
COIN - I Think I Met You In A Dream
SEB - fuck it, i'm the man
Beach House - Hurts to Love
Nil√ºfer Yanya - anotherlife
Dehd - Bad Love
Alicia Creti - Congratulations
Ozuna - Deprimida
Buddy - Wait Too Long (feat. Blxst)
Scorey - Girls Love Rod Wave
Mahalia - Letter To Ur Ex
DOE - Clarity
Jon Pardi - Last Night Lonely
Steve Aoki - KULT (feat. Jasiah)
Tobias Dray - Espada Primo
Chappell Roan - Naked in Manhattan
THE BLSSM - DIZZY
Wallice - Little League
DWLLRS - Float Through The Ceiling
Teezo Touchdown - Handyman
Mooski - Soul Bleed
Melii - Cartier
Goyo - Na Na Na
Alok - Headlights (feat. KIDDO)
Regard - Hallucination
Metronomy - Right on time
Grentperez - Why I Love You
Kurt Vile - Like Exploding Stones
Fontaines D.C. - I Love You
Nothing But Thieves - Life's Coming in Slow - from GRAN TURISMO 7
Jake Owen - Fishin' On A River
Sean Stemaly - Can't Be Me
Eddie Benjamin - Weatherman
Lukas Graham - All Of It All
Louis The Child - Blow The Roof (with Kasbo & EVAN GIIA)
OHGEESY - Let Me Know (feat. Kalan.FrFr)
Iayze - 556 (Green Tip)
Fredo Bang - 4's Up
Mwami - danser
Bob Moses - Never Ending
Future Islands - King of Sweden
Mila Degray - purple ribbon
Toast - 5am
Isaac Dunbar - Bleach
Romeo Santos - Sus Huellas
Kungs - Clap Your Hands
The Knocks - Slow Song (with Dragonette)
Tion Wayne - Knock Knock
Curren$y - Louis Baggage (feat. Babyface Ray)
Porsh Bet$ - Here
Ryan Hall - FRIENDS
Carlie Hanson - Girls In Line for the Bathroom
Zolita - Single In September
Hurray For The Riff Raff - SAGA
Train - AM Gold
JP Cooper - Radio
BROODS - I Keep (feat. Tove Lo)
KAIRO - Someone Like You
Liam Benzvi - Acts of Service üïí
93FEETOFSMOKE - FUCKED OVER (feat. phem and Tosh the Drummer)
Big K.R.I.T. - Southside of the Moon
Pyrex Pryce - Busy Body
Boslen - LEVELS
IV4 - Can't Find Love in L.A
David Saint Val - Codependency
Jack Van Cleaf - Wild RosesYou might also likeEmbed Everything But You (feat. A7S) Everything But You (feat. A7S) Clean Bandit;A7S funk