1 ContributorNew Music Friday 04/08/22 LyricsJack Harlow - First Class
Lil Baby - Right On
Camila Cabello - psychofreak (feat. WILLOW)
Charlie Puth - That's Hilarious
Fivio Foreign - Changed On Me (feat. Vory & Polo G)
Pusha T - Neck & Wrist (feat. JAY-Z & Pharrell)
Chlöe - Treat Me
Wet Leg - Ur Mum
Omar Apollo - Petrified
David Guetta - Crazy What Love Can Do
Maggie Rogers - That's Where I Am
Noah Cyrus - I Burned LA Down
Lizzy McAlpine - hate to be lame (feat. FINNEAS)
Yung Lean - Bliss
Coi Leray - Mountains (with Fivio Foreign & Young M.A)
Lauv - All 4 Nothing (I'm So In Love)
Kelsea Ballerini - HEARTFIRST
Gracie Abrams - Block me out
ROLE MODEL - rx
BIA - LONDON (feat. J. Cole)
ScHoolboy Q - Soccer Dad
Syd - Out Loud (fеat. Kehlani)
Orville Peck - Lеt Me Drown
Sasha Alex Sloan - I Blame The World
Tom The Mail Man - FWM2
Vince Staples - LEMONADE
Ozuna - Apretaito
bbno$ - mathematics
Maude Latour - Lola
Cole Swindell - She Had Me At Heads Carolina
Jack White - What's the Trick?
CORPSE - POLTERGEIST!
42 Dugg - Thump Shit
Tyga - Lifetime
Bankrol Hayden - Fuck Love
MASN - Love Me For Me
anees - sun and moon
Father John Misty - Kiss Me (I Loved You)
Alicia Keys - City of Gods (Part II)
John Legend - FREE
Fousheé - double standard
Doechii - Crazy
AURORA - The Woman I Am
Cian Ducrot - All For You
Bob Moses - Need You Tonight - Spotify Singles
ericdoa - lifeline
Caitlyn Smith - Maybe In Another Life
Carrie Underwood - Denim & Rhinestones
Bishop Briggs - High Water
Arden Jones - la di da - acoustic
Vance Joy - Clarity
IDK - Taco
Mike Posner - Home
Wiz Khalifa - Ain’t No Fun
IVE - LOVE DIVE
Empress Of - Save Me
Katherine Li - Never Had a Chance
chloe moriondo - nice pup
Wallice - 90s American Superstar
The Linda Lindas - Why
J.I the Prince of N.Y - Toxic
B-Lovee - All In
Natanael Cano - Brillo
Big Gigantic - Deja Vu
Hayden James - Lights Go Down (with SIDEPIECE)
BANKS - Fuck Love
Dylan - Live Without It
Allison Ponthier - Autopilot
carolesdaughter - Audrey
Rainbow Kitten Surprise - Work Out
Lucius - Promises
Miranda Lambert - Actin' Up
Matteo Bocelli - Tu Luz Quedó (con Sebastian Yatra)
Lele Pons - Piketona (with Kim Loaiza)
ElyOtto - DAYZEE
HEALTH - NO ESCAPE
Peach Tree Rascals - Good Advice
DE'WAYNE - DIE OUT HERE (feat. POORSTACY)
The Regrettes - Barely on My Mind
Sophie May - With The Band
Chxrry22 - The Falls
NO1-NOAH - Bonjour (feat. Summer Walker)
Lil Silva - Backwards
Rozie Ramati - Orange Juice
Groupthink - Guilty Pleasure
Ryann - Last Call
Jillian Jacqueline - Better With A Broken Heart (feat. TJ Osborne)
Jack Johnson - One Step Ahead
Papa Roach - No Apologies
Pink Floyd - Hey Hey Rise Up - feat. Andriy Khlyvnyuk of Boombox
niina - miss u
HENNESSY - ALL FOR NOTHING
Avril Jensen - COLORS
El Alfa - Maquina de Dinero
Rob49 - Phone Ringing
Rehmahz - Easy
Frost Children - FOX BOP
Gavin Leatherwood - Be My Lover
Annie Blackman - PicketsEmbed LONDON (feat. J. Cole) LONDON (feat. J. Cole) BIA;J. Cole latin