4 ContributorsNew Music Friday 08/24/18 LyricsAlec Benjamin - Death of a Hero
Liam Payne - Home With You
Disclosure - Where Angels Fear To Tread
Logic - The Return
Jason Derulo - Goodbye (feat. Nicki Minaj & Willy William)
Bring Me The Horizon - MANTRA
GASHI - Creep On Me
Ozuna - Ibiza
BTS - IDOL
Radiant Children - Tryin'
Conor Matthews - Inside Out
Noah Cyrus - Live or Die
KYLE - Moment (feat. Wiz Khalifa)
Blood Orange - Chewing Gum
Bas - Tribe (with J. Cole)
Dounia - How I See It
Julien Baker - Me & My Dog
Goody Grace - Girls in the Suburbs Singing Smiths Songs (feat. G-Eazy)
Blackbear - the 1
Florida Georgia Line - Sittin’ Pretty
Nick Jonas - Right Now
Valley Hush - Letting a Flower Die
Jessie Reyez - Body Count (Remix) (feat. Normani & Kehlani)
$uicideBoy$ - Meet Mr. NICEGUY
Houses - Fast Talk
Hippo Campus - Bambi
Young the Giant - Superposition
Fall Out Boy - Lake Effect Kid
The Frights - Over It
Matoma - Losing It Over You (feat. Ayme)
Kim Petras - All the Time
Kiiara - Gloe
Black Coffee - Drive (feat. Delilah Montagu) - Edit
T-Pain - Might Be (feat. Gucci Mane)
Cautious Clay - Crowned
LANY - I Don't Wanna Love You Anymore
HONNE - Crying Over You ◐
Sports - Autopilot
Model Tenant - Real Like You
The Chainsmokers - Save Yourself
Barns Courtney - "99"
Seth Ennis - Call Your Mama (feat. Little Big Town)
Lil Durk - Spin The Block (feat. Future)
YoungBoy Never Broke Again - 2 Hands (feat. Kevin Gates)
Saweetie - Up Now (feat. G-Eazy and Rich The Kid)
Tungevaag & Raaban - Bad Boy (feat. Luana Kiara)
The Blaze - Faces
Comethazine - Walk
Lucie Silvas - Kite
Alex Aiono - Big Mistake
Empress Of - When I'm With Him
Yumi Zouma - In Camera
REASON - Better Dayz
Shae Jacobs - Fuck Me Up
Tori Kelly - Never Alone
Disclosure - Love Can Be So Hard
Poppy - Time Is Up
R3HAB - Rumors (With Sofia Carson)
Rosette - Single For The Summer
Masego - Old Age
Brett Dennen - Be Somebody
Robert DeLong - Revolutionary
Hunter Hayes - One Shot
NOTD - Been There Done That (feat. Tove Styrke)
Mac DeMarco - Honey Moon
Anik Khan - Big Fax
for KING & COUNTRY - Amen
Grace Carter - Why Her Not Me
Atreyu - Anger Left Behind
Life of Dillon - MIA
The Afters - Well Done
Interpol - If You Really Love Nothing
Apollo LTD - Gold
Aya Nakamura - Copines
Soccer Mommy - I'm on Fire
Rubblebucket - Party Like Your Heart Hurts
Ivy Sole - Backwoods
Brandon Ray - Second Thoughts
Cade Thompson - Grateful (Neon Feather Remix)
Evaride - Warrior
Andy Black - My Way
Anki - Above
Ofenbach - Paradise (feat. Benjamin Ingrosso)
Jain - Oh Man
Kodaline - Head Held High
Meghan Trainor - LET YOU BE RIGHT - Recorded at Sound Stage Studios Nashville
Nicky Romero - Rise
NEIKED - Been A Long Time
Tunde Olaniran - Mountain
Jaguar Dreams - Just Life
Valentina - Break My Heart
Vlad Holiday - Like in the Movies
Emma Louise - Falling Apart
Ekali - Leaving (feat. Yuna)
Neil & Liam Finn - Anger Plays A Part
Justice - Love S.O.S. (WWW)
Kyson - Every High
CLOVES - Hit Me Hard
Yeek - Solstice
Clara - Slippin´Embed Bad Boy (feat. Luana Kiara) Bad Boy (feat. Luana Kiara) Raaban;Tungevaag;Luana Kiara edm