1 ContributorNew Music Friday 10/22/21 LyricsSwedish House Mafia - Moth To A Flame (with The Weeknd)
Moneybagg Yo - Scorpio
Majid Jordan - Stars Align (with Drake)
Elton John - Always Love You
DJ Snake - SG (with Ozuna, Megan Thee Stallion & LISA of BLACKPINK)
Wale - Name Ring Bell
Quavo - Strub Tha Ground (Feat. Yung Miami)
Lil Tjay - Not In The Mood (feat. Fivio Foreign & Kay Flock)
Mimi Webb - Halfway
Lana Del Rey - If You Lie Down With Me
Khalid - Present
BIA - CAN'T TOUCH THIS
Pink Sweat$ - Nothing Feels Better
347aidan - IDONTWANNATALKTOYOU! (with renforshort)
Aries - ONE PUNCH
RÃœFÃœS DU SOL - I Don't Wanna Leave
Wet - Bound (with Blood Orange)
Gracie Abrams - Rockland
Bastille - No Bad Days
Christina Aguilera - Pa Mis Muchachas (feat. Nathy Peluso)
Kota the Friend - Show You
Maxo Kream - STREETS ALONE (feat. A$AP Rocky)
Ashnikko - Halloweenie IV: Innards
Joy Oladokun - I Can't Make You Love Me - Spotify Singles
Tenille Arts - Growing Old Young
Dijon - Rodeo Clown
Ritt Momney - HEADSTART
Culture Jam - Bestie
ILLENIUM - Hurts Like This
Jack White - Taking Me Back
JPEGMAFIA - DIRTY!
Big Sean - What A Life
Sean Paul - Dynamite
ABBA - Just A Notion
Lady A - Friends Don't Let Friends
carolesdaughter - My Mother Wants Me Dead
keshi - SOMEBODY
Dreamer Boy - ARE YOU LETTING GO? (feat. BENEE)
Dean Lewis - Looks Like Me
James Arthur - SOS
AngÃ¨le - Bruxelles je tâ€™aime
Hope Tala - Tiptoeing
GENER8ION - Neo Surf
Steve Aoki - Equal in the Darkness
Craig David - Who You Are
Paloma Mami - Cosas De La Vida
2KBABY - Luigi (feat. Chief Keef)
Fetty Wap - The Truth
Felly - Fresh Water
Baird - Easy On Them Turns
Fiji Blue - Flower in the Dark
HONNE - THREE STRIKES (feat. Khalid)
Yot Club - Alive
No Rome - When She Comes Around
Shallou - High Tide
Jonah Kagen - Catching A Dream
ROSIE - All my favorite songs
Katelyn Tarver - Hurt Like That
Abby Anderson - Bad Posture
My Morning Jacket - In Color
Bonobo - Tides
Benny Benassi - Let Me Go (with Ne-Yo)
Bktherula - IDK WHAT TO TELL YOU
Kendra Jae - BIG
SEVENTEEN - Rock with you
CL - Tie a Cherry
Cannons - Ruthless
Lani Rose - Autumn
808vic - oops
Yeek - Feels Like I'm Flying
Cozz - Fortunate
Wiz Khalifa - Million Dollar Moment
Sebastian Yatra - Tacones Rojos
DVBBS - Do It Anyway (with Icona Pop)
Jillian Rossi - Hurt Again
Hippo Campus - Boys
August Royals - Prada
NEIL FRANCES - Be Free
Animal Collective - Prester John
Helado Negro - There Must Be a Song Like You
joe p - Crown Vic (Black Cloud)
Sam Ezeh - What For?
Sarah Proctor - Not For Me
Jessie James Decker - The Woman I've Become
Kassi Ashton - Heavyweight
Avery Lynch - When It Ends
Suriel Hess - Hurt Me
NorthSideBenji - Money Showers
Never Broke Again - Red Steps
Alvaro Diaz - ProblemÃ³n
A7S - By My Side ðŸ•’
Sally Sossa - Weird 2 Me ðŸ•’
Kuttem Reese - Pallbearers
dexter - Paper Cup
Jada Kingdom - Jungle
Dua Saleh - tic tic (with Haleek Maul)
Wabie - Crowd Surf
Siiickbrain - Zombie
Parquet Courts - Homo SapienEmbed Stars Align (with Drake) Wildest Dreams Majid Jordan;Drake soul