2 ContributorsNew Music Friday 10/12/18 LyricsBad Bunny - MIA (feat. Drake)
Quavo - PASS OUT (feat. 21 Savage)
Belly - Immigrant
Jess Glynne - Thursday
Kodak Black - ZEZE (feat. Travis Scott & Offset)
Shawn Mendes - Under Pressure
Little Mix - Woman Like Me (feat. Nicki Minaj)
Ella Mai - Gut Feeling (feat. H.E.R.)
ALMA - Cowboy
Petit Biscuit - Suffer
Sia - I'm Still Here
Usher - Gift Shop (feat. Gunna)
Shy Glizzy - Super Freak (feat. Lil Uzi Vert)
Mike Perry - Rise & Fall
Shoffy - Cool Again
Quavo - SWING (feat. Normani & Davido)
Weezer - Can't Knock The Hustle
Dan + Shay - Million Reasons - Recorded at Sound Stage Studios Nashville
Morgan Evans - Dance with Me (feat. Kelsea Ballerini)
Free Nationals - Beauty & Essex (feat. Daniel Caesar & Unknown Mortal Orchestra)
Cheat Codes - Home
Wallows - Drunk on Halloween
Parcels - Withorwithout
Maggie Rogers - Light On
FIDLAR - Can’t You See
Camila Cabello - Consequences - orchestra
Meg Mac - Give Me My Name Back
MihTy - Goin Thru Some Thangz
Allan Rayman - Rose
Run The Jewels - Let's Go (The Royal We)
Valerie Broussard - Hold on to Me
CAZZETTE - In Time
Carling - How Low
Atreyu - In Our Wake
THEY. - What I Know Now (feat. Wiz Khalifa)
Rvssian - Pablo (with Sfera Ebbasta & Rich The Kid feat. Moneybagg Yo & Lil Baby) - Remix
RAT BOY - INTERNATIONALLY UNKNOWN
Tom Morello - Find Another Way (feat. Marcus Mumford)
Keith Ape - The Ice Ape (feat. Chief Keef)
Svrcina - Come Together
Great Good Fine Ok - Easy
Astrid S - Emotion
Josh Groban - Bridge Over Troubled Water - Recorded at Spotify Studios NYC
Michael Bublé - Love You Anymore
Lukas Graham - Not a Damn Thing Changed
outsideOUTSIDE - Colder
Kurt Vile - Yeah Bones
Poppy - Fashion After All
Plies - All Thee Above (feat. Kevin Gates)
Seven Lions - First Time
Lost Kings - Drunk As Hell
Valley Hush - Foolish
Siena Liggins - Naked
Middle Kids - Salt Eyes
Hands Like Houses - Monster
Young Scooter - New Hunnids (feat. Yung Bans & Gunna)
Basement - Slip Away
Yoshi Flower - OF THE UNITED STATES OF AMERICA
YONAKA - Own Worst Enemy
Miya Folick - Thingamajig
Jimmie Allen - County Lines
Steve Brian - Wait For Me
Lil Silva - Always Wonder
The Brother Brothers - Red And Gold
Frances Cone - Wide Awake
Pistol Annies - Stop Drop and Roll One
COIN - Simple Romance
Little Dragon - Lover Chanting - Edit
Grace Carter - Why Her Not Me - Recorded At RAK Studios, London
Pink Sweat$ - Would You
Eleven’ - Losing My Mind
ASHLEE + EVAN - Home
FRANKIE - When I'm Ready
Old Dominion - Make It Sweet
Casting Crowns - Nobody (feat. Matthew West)
Fancy Feelings - NYLA
Doc Robinson - All I Know Is
Rosie Carney - Orchid
The Lone Bellow - You Can Be All Kinds of Emotional (Acoustic)
Bonsai Mammal - Like Water
TobyMac - Starts With Me
Galvanic - All of My Time
Christon Gray - Grow Up
Rayland Baxter - Strangers
Colter Wall - Wild Dogs
Jacob Banks - Slow Up
Trevor Daniel - Mess
Laura Jane Grace & the Devouring Mothers - The Airplane Song
Jinka - Don't Work Like That
SASAMI - Not The Time
Elvis Costello - Don't Look Now
LINES - People (feat. Adele Kosman)
Horizon - In The Morning (feat. Bianca and Sammy Arriaga)
Natalie - Palm Trees
Aries - RACECAR
Kbubs - Love Again
BRONCHO - All Choked UpEmbed Beauty & Essex (feat. Daniel Caesar & Unknown Mortal Orchestra) Free Nationals Free Nationals;Daniel Caesar;Unknown Mortal Orchestra soul