1 ContributorNew Music Friday 09/02/22 LyricsLil Baby - Detox
Ari Lennox - Queen Space (with Summer Walker)
Arctic Monkeys – There’d Better Be A Mirrorball
Kali Uchis - NO HAY LEY
Chlöe- Freak Like Me - Spotify Singles
Charlie Puth - Smells Like Me
Romeo Santos - Sin Fin
Dermot Kennedy - Kiss Me
YUNGBLUD - Tissues
Yeat - Talk
Gorillaz - New Gold (feat. Tame Impala and Bootie Brown)
Justin Bieber - Beautiful Love - Free Fire
Ava Max - Million Dollar Baby
The 1975 - I'm In Love With You
Jon Pardi - Your Heart Or Mine
Kenny Beats - Hold My Hеad
Freddie Gibbs - Too Much (feat. Monеybagg Yo)
Imagine Dragons - Love Of Mine - Night Visions Demo
FLETCHER - Sting
Gucci Mane - Look Ma I Did It
GloRilla - Blessed
Payday - White Mercedes
Maude Latour - Cyclone
Nonso Amadi - Eye to Eye
DJ Drama - I Ain’t Gone Hold Ya
NLE Choppa - Little Miss
DE'WAYNE - TAKE THIS CROWN (feat. Good Charlotte)
Kelsea Ballerini - WHAT I HAVE
Dean Lewis - How Do I Say Goodbye
Two Door Cinema Club - Everybody's Cool
Yuna - Fool 4 U
Tyga - Fantastic
Pi’erre Bourne- Psane (feat. Don Toliver)
aldn - say what u mean (with Riovaz)
Arden Jones - mr. sunshine
Yung Lean - Lazy Summer Day
Louis Tomlinson - Bigger Than Me
Nina Nesbitt - I Should Be a Bird
Sigala - Living Without You
Shygirl - Nike
EST Gee - Hell
PnB Rock - Luv Me Again
DannyLux - No Te Quiero Perder
JESSIA - One of the Guys
Matt Hansen - break my heart
Jenna Raine - Fumbled the Bag
INJI - MADELINE
Quando Rondo - Give Me A Sign
Pierce The Veil - Pass The Nirvana
Rodell Duff - Just In Case
Alex Warren - Headlights
Tove Styrke - Another Broken Heart
Lous and The Yakuza - Handle Me (feat. Adekunle Gold)
Nicki Nicole - Nobody Like Yo
Dillon Francis - Goodies
Reggie Becton - Sway
The Front Bottoms - The Bongo Song
Sueco - Funeral
Chet Faker - It Could Be Nice
Bishop Briggs - Lessons of the Fire (from the Netflix Series "Devil In Ohio")
Connie Constance - Mood Hoover
Cam’Ron & A-Trak - All I Really Wanted
Duckwrth - Beg
Sans Soucis - All Over This Party
Kings Elliot - Cry, Baby, Cry
Danielle Bradbery - A Special Place
Tenille Townes - The Last Time
Jillian Rossi - Like A Boy
flor - Every Night
lilspirit - twice
Tay Money - Hands Up (with Monaleo)
JADED - Zorro
Sonny Fodera - Remember (feat. Stevie Appleton)
Wisin - Tiempo
Gabrielle Aplin - Don't Know What I Want
Plains - Abilene
Boon - Make Me Stay
Sally Sossa - Certified Stepper (with PGF Nuk)
MisterWives - Wrongside
Jades Goudreault - this town is a little less mine
Durand Bernarr - Lil Bit
TSHA - Dancing In The Shadows
Mount Kimbie - in your eyes
Polyphia - ABC (feat. Sophia Black)
Jiubel - Scooby Doo
Megan Moroney - Tennessee Orange
Rayland Baxter - If I Were A Butterfly - Single Version
Emma Bradley - Renew Me
dodie - Hot Mess
Bloomsday - Jersey Soccer
Talia Goddess - RAGGA
Niko Eme - Probao
HAPPY LANDING - Eloise
Enisa - Zoom
Orchid - I Crave It
Xowie Jones - Bury Me Alive
Rot Ken - No Mind
altrice - yoni
Natasha Hunt Lee - The End of the WorldEmbed New Gold (feat. Tame Impala and Bootie Brown) New Gold (feat. Tame Impala and Bootie Brown) Gorillaz;Tame Impala;Bootie Brown alternative