2 ContributorsNew Music Friday 01/25/19 LyricsJ. Cole - MIDDLE CHILD
Dua Lipa - Swan Song - From "Alita: Battle Angel"
Tyga - Girls Have Fun
Julia Michaels - What A Time (feat. Niall Horan)
Lauv - i'm so tired...
Vampire Weekend - Harmony Hall
Peter Manos - You Don't Know Me
Yo Gotti - Put a Date On It (feat. Lil Baby)
GASHI - My Year
Bring Me The Horizon - mother tongue
Daddy Yankee - Con Calma
Boogie - Rainy Days (feat. Eminem)
Call Me Karizma - Monster - Under My Bed
Foals - Exits - Edit
Vampire Weekend - 2021
Luke Christopher - AGAINST ME
XXXTENTACION - Sauce!
Jack & Jack - Day Dreaming
FLETCHER - Undrunk
Luis Fonsi - Sola
Drama Relax - Private
X Ambassadors - BOOM
Weezer - Take On Me
Cassadee Pope - If My Heart Had A Heart
TROSSTHEGIANT - BigStuff
morgxn - blue
FIDLAR - Flake
Backstreet Boys - New Love
Soulja Boy - Cut Dat Check
Alvaro Soler - Loca
Hunter Hayes - Heartbreak
AURORA - Animal
Summer Walker - Riot
Better Oblivion Community Center - Dylan Thomas
Dido - Give You Up
Wynne - DL
Peter Manos - Out of Love
Lukas Graham - SAD! - Recorded at Spotify Studios Stockholm
ARTY - Save Me Tonight
T-Pain - Getcha Roll On (feat. Tory Lanez)
Shae Jacobs - Not Supposed To
Julia Michaels - Anxiety (with Selena Gomez)
Dreezy - Ecstasy (feat. Jeremih)
Ryan Adams - Fuck The Rain
M-22 - White Lies
Yolanda Be Cool - Dance & Chant
Blueface - Bleed It
gianni & kyle - close
Rudimental - Dark Clouds (feat. Jess Glynne & Chronixx)
Florence + The Machine - Moderation
Robinson - Karma
King Princess - I Know (feat. Fiona Apple) - RISE Recording
Celeste - Father's Son
Pretty Vicious - These Four Walls
Rauw Alejandro - Que Le De
Decco - Crazy to Love You
Drax Project - Woke Up Late (feat. Hailee Steinfeld)
Grizfolk - Heavy Crown
Kassi Ashton - Violins
Noé - Pity Party
Tori Kelly - Change Your Mind
Terror Jr - Terrified
Spiral Stairs - Hyp-No-Tized
Maxo Kream - Meet Again
Nicky Romero - Distance
mags - you're in his bed, i'm in his head
American Football - Uncomfortably Numb
ILLENIUM - Crashing (feat. Bahari)
Anitta - thank u, next - Recorded At Spotify Studios NYC
King Calaway - World For Two
Grace Carter - Heal Me
Lolo Zouaï - Jade (feat. Blood Orange)
Kirk Franklin - Love Theory
Ashley Tisdale - Love Me & Let Me Go
Beck - Tarantula - Music Inspired by the Film Roma
Isabelle Brown - What U Waiting 4
Cassette Tapes - This Year
Joy Williams - Front Porch
girl in red - watch you sleep.
VOWWS - Structure of Love II - Renholdër Remix
Maesu - Amen
Gus Dapperton - My Favorite Fish
Broods - Falling Apart
Alex Siegel - Later
Savannah Locke - Jaded
Jenny Lewis - Red Bull & Hennessy
Rival Sons - Too Bad
GoldLink - Got Muscle (feat. Peewee Longway & WaveIQ)
Dirty Heads - Listen To Me
Lambchop - Everything for You
Chloe Lilac - Manic Pixie Dream
Rosie Carney - Humans
Two Friends - Take It off
Shepherd - Gametime
RAT BOY - I WANNA SKATE
Diplo - Boom Bye Bye
Eric Heron - Die Down
Zac Flewids - Steps
Switch - Symphony - Radio EditEmbed What A Time (feat. Niall Horan) Inner Monologue Part 1 Julia Michaels;Niall Horan electro