1 ContributorNew Music Friday 12/27/19 LyricsTravis Scott - HIGHEST IN THE ROOM (feat. ROSAL√çA & Lil Baby) - REMIX
Kehlani -‚ÄÖAll‚ÄÖMe (feat. Keyshia‚ÄÖCole)
Sunday Service Choir - Ultralight Beam
Ariana‚ÄÖGrande - nasa - live
Bring Me The Horizon - ¬ø (feat. Halsey)
Alan Walker - Alone, Pt. II
Martin Garrix - Hold On (feat. Michel Zitron)
DJ Snake - Loco Contigo (with J. Balvin & Ozuna feat. Nicky Jam, Natti Natasha, Darell & Sech) - REMIX
Burna Boy - Money Play
JACKBOYS - OUT WEST (feat. Young Thug)
Yung Pinch - Over It (feat. Wiz Khalifa)
TheHxliday - Mistakes
Prince Royce - Dec. 21
Ayelle - Okay
Party Pupils - The Plug (feat. Drelli)
JACKBOYS - WHAT TO DO? (feat. Don Toliver)
Kid Ink - Ride Like A Pro (feat. Reo Cragun)
Blanco Brown - The Git Up (feat. Ciara) - Remix
J Hus - No Denying
IAMDDB - Bubble Tea
Red Velvet - Psycho
Like Mike - Sinner
gnash - alright
Ruben - As Long As I Break Your Heart
Smino - Sleigh (with Monte Booker & Masego)
G Herbo - Sessions
16yrold - Drought (16yrold & KILLY)
Chris Webby - Stuck In My Ways
hannah hausman - too weak
Blaenavon - whatever √º wanna B
Mighty Oaks - Lost Again
Syn Cole - Keep Going
Cub Sport - Air
Nitti Gritti & FuntCase - To Death
Don Patricio - 22:23
Your Old Droog - BDE  üêö
D-Block Europe - No Cellular Site
Boyfriend - Lie in It
Brothers Page - Cause the World Is Small
Great Good Fine Ok - 2020
Nue - Easy Call
Eva Shaw - STRIP
Andrew Applepie - No ID
damnboy! - Baby!
Joshua Hyslop - Behind the Light
Kina Grannis - Somebody Loved
The Secret Sisters - Hold You Dear
Kadeema - Gotta Get It
GRMLN - Dog
John Mulaney - Music, Music Everywhere!Embed HIGHEST IN THE ROOM (feat. ROSAL√çA & Lil Baby) - REMIX JACKBOYS Travis Scott;ROSAL√çA;Lil Baby house