3 ContributorsNew Music Friday 1/29/21 LyricsBaila Conmigo (with Rauw Alejandro) - Selena Gomez
You (with Marshmello & Vance Joy) - benny blanco
Finesse Out The Gang Way (feat. Lil Baby) - Lil Durk
Agua de Jamaica - Maluma
Gravity (feat. Tyler, The Creator) - Brent Faiyaz
Holy Water - Lil Mosey
Higher (feat. iann dior) - Clean Bandit
Tonight Tonight - Celeste
Hope - Arlo Parks
IDWK - 347aidan
Don't Judge Me - FKA twigs
"BOP" - CJ
GFU (feat. Yung Kayo) - Young Stoner Life
Loco - Anitta
All You Ever Wanted - Rag'n'Bone Man
Bandaid On A Bullet Hole - Bonus - Morgan Wallen
Last Day In - Kodak Black
TIRED - Jack Kays
Tarantino - Araya
LET'S GET MARRIED - PARTYNEXTDOOR
help herself - bbno$
Cry Over Boys - Alexander 23
Immune - Jensen McRae
DJ - Sam Dew
STAR (feat. Erica Banks) - Yella Beezy
proud - ssgkobe
Vintage - Blu DeTiger
Stronger (feat. Kesha) - Sam Feldt
Wingman - Boys World
lonely & pathetic - LØLØ
Only a Matter of Time - Joshua Bassett
Parking Spot - PRETTYMUCH
Broken - Jonah Kagen
She's Mine - Lauren Weintraub
Stressed - Lonely God
Dolphin - Payday
It's Time To Rock - Tes X
Grapes Of Wrath - Weezer
Seize the Power - YONAKA
Sex With Me - TRAMP STAMPS
All I Need - Verzache
Rounds - 2KBABY
FIX URSELF! - JPEGMAFIA
Big League - O.T. Genasis
If You Know You Know (feat. Moneybagg Yo) - Babyface Ray
california world - Lil Peep
change ur mind - Sarcastic Sounds
Momma Always Told Me (feat. Stanaj & Yung Bae) - Mike Posner
Homicide - Slimelife Shawty
Bounty - Rexx Life Raj
Know The Rules - Tokyo Jetz
i'm drunk and i miss you still (feat. 1nonly & lilbubblegum) - Savage Ga$p
Look at the Sky - Porter Robinson
Sorry (feat. ISÁK) - Alan Walker
World League - AMA
Fellowship - serpentwithfeet
Itsy Bitsy - Lyn Lapid
Canary Islands - Goth Babe
You Don't Own Me - Pale Waves
C'est La Vie - The Killers
Somebody - Yuno
Sunny - Artemas
Hypocrite - Trapboy Freddy
This That Shit - Haiti Babii
What U Want - Caleborate
Feelin' Me - Marzz
American Mood - JoJo
We All Have (feat. Matt Berninger) - Julia Stone
Stuck Here Without You - yaeow
Two for 2 - For Dilla - Madlib
FYO - MICHELLE
Lucky - Nasty Cherry
Girlfriend - Rebecca Black
Tu Verdad (with Cazzu) - Dylan Fuentes
Hood Dreams - LBS Kee'vin
Add It Up - Bankroll Freddie
City of The Rose - Katori Walker
ANTI QUEEN - Bri Steves
Tigress & Tweed (Music from the Motion Picture "The United States vs. Billie Holiday") - Andra Day
Do With Me What You Want - NASRI
Baby Who - Michael Brun
Colours - Hayla
Run It Up - Seeb
Never Never Never - Baio
live forever - almost monday
Everything We Need - A Day To Remember
O.N.E. - King Gizzard & The Lizard Wizard
under - Jeris Johnson
[Little Booties Matter - Wes Period]x
Lose My Mind - TruCarr
Stackin It (with Gunna) - Nechie
Into The Unknown - Don Diablo
Waiting for Rain - SEU Worship
Heart On Fire - Eric Church
Morning Prayer - Langhorne Slim
[Message in a Bottle - Lakeview]x
Heavy - Rosie Darling
lost - edit - Daniel Briskin
Ten Feet Tall - Charlie Hickey
Meet Me - 5am2Embed You (with Marshmello & Vance Joy) You (with Marshmello & Vance Joy) benny blanco;Marshmello;Vance Joy electro