1 ContributorNew Music Friday 09/16/22 LyricsBLACKPINK - Shut Down
Fred again.. - Danielle (smile on my face)
EST Gee - Backstage Passes (feat. Jack Harlow)
Wizkid - Bad To Me
Noah Cyrus - I Just Want a Lover
Feid - Prohibidox
Jessie Reyez - ONLY ONE
Charlie Puth - I Don’t Think That I Like Her
BLEU & Nicki Minaj- Love In The Way
Rina Sawayama - Hurricanes
Weyes Blood - It's Not Just Me, It's Everybody
G Herbo - Blues (feat. Future)
Bazzi - Only Fan (feat. Cordae)
FLETCHER - Serial Heartbreaker
AG Club - Don't Ask, Don't Tell (feat. redveil, Sam Truth & Glen the Saiyan)
Mura Masa & slowthai- up all week
Kodak Black - Walk
Mitchell Tenpenny - We Got History
Marcus Mumford - Better Angels
Noah Kahan - Northern Attitude
Jeremy Zucker - I'm So Happy
Djo - End of Beginning
Jean Dawson - PIRATE RADIO*
Tai Verdes - TWO SUGARS
Little Big Town - Three Whiskeys And The Truth
GAYLE & blackbear– fmk
Kiana Ledé - Irresponsible
Danielle Ponder - Someone Like You
Blood Orange - Wish
Death Cab for Cutie - Asphalt Meadows
Paulo Londra - Party en el Barrio (feat. Duki)
Anne-Marie - PSYCHO
Ayra Starr - Rush
Father John Misty - I Believe (When I Fall In Love It Will Be Forever)
Björk- Ovule
Carly Rae Jepsen - Talking to Yourself
Daya - See You In My Dreams
Maggie Lindemann - cages
UPSAHL - Antsy
Koe Wetzel - Money Spent
Adam Blackstone - 'Round Midnight
Montell Fish - Hotel
Ab-Soul - Moonshooter
MAVI - Baking Soda
Nick Hakim - Vertigo
JAWNY - adios
Whitney - LOST CONTROL
David Kushner - Look Back & Laugh
Bailey Zimmerman - Never Leave
ILLENIUM - From The Ashes (with Skylar Grey)
Kx5 - Take Me High
Ozuna - La Copa
EKKSTACY - i just want to hide my face
Lolo Zouaï - pl4yg1rl
Babyface - Game Over (with Queen Naija)
Kelela - Washed Away
Little Dragon - Stay
Ondara - A Seminar In Tokyo
Indy - Threads
Kelsea Ballerini - IF YOU GO DOWN (I'M GOIN' DOWN TOO)
Becky G - AMANTES
Symba - Never Change (feat. Roddy Ricch)
Kaash Paige & 6LACK - Miss My Dawgs
Lost Kings - Save Me (feat. Kiddo A.I.)
mxmtoon - plastic pony
Dora Jar - Bump
Phil Good - Destination OK
emlyn - my best friend's ex
chloe moriondo - Cdbaby<3
Sueco - Last Thing I Do
Steve Aoki - Movie Star (ft. MOD SUN & Global Dan)
Jack Kays - Finally Fine
Jeffrey Eli - CASPER
TINI - El Último Beso
Tee Grizzley - Robbery Part 4
Nasty C - Born To Win
Cam’Ron - Ghetto Prophets (feat. Conway the Machine)
Alex Vaughn - Talkin
Lissie - Chasing the Sun
Kings Elliot - Ashes By The Morning
Joesef - Joe
Bladee - DRAIN STORY
The Scarlet Opera - The Place To Be
Dylan - Nothing Lasts Forever
lilianne - Drunk Text
James Hype - Crank
B-Lovee - One Time (feat. Ice Spice, Skillibeng & J.I the Prince of N.Y)
KA$HDAMI - less than me (with NoCap)
Lojay - LEADER!
We The Kingdom - Mine
Kat & Alex - Marry You
Kylie Morgan - Bridesmaids
judith - DND
DavidTheTragic - 19
YOVNGCHIMI - Baby Glock
Pink Siifu - Tokyo Blunts (feat. Armand Hammer & Conquest Tony Phillips)
S.O. - LOOK AT ME NOW
LeAnn Rimes - spaceship
Naomi Wild - HOW U FEELINEmbed From The Ashes (with Skylar Grey) From The Ashes (with Skylar Grey) ILLENIUM;Skylar Grey house