2 ContributorsNew Music Friday 12/01/17 LyricsG-Eazy - Him & I feat. Halsey
Sasha Sloan - Runaway
Martin Garrix & David Guetta - So Far Away feat. Jamie Scott & Romy Dya
Ed Sheeran & Beyoncé - Perfect Duet
Blackbear & Ne-Yo - top priority
Louis Tomlinson - Miss You
PRETTYMUCH - No More feat. French Montana
Miguel - Come Through and Chill feat. J. Cole & Salaam Remi
Logic & Rag'n'Bone Man - Broken People
Roy Woods - Monday to Monday
Chief Keef - Glory Bridge feat. A Boogie Wit da Hoodie
Kiesza & SKYGGE - Hello Shadow
Pitbull - Mucho Booty feat. Farruko & Micha
LANCO - Born to Love You
Chris Stapleton - Midnight Train To Memphis
U2 - Love Is Bigger Than Anything In Its Way
The Brinks - Never Get High Enough When You Buy The Drugs
Yogi - Cakin' feat. DRAM & Lady Leshurr
Juicy J - Kamasutra feat. Cardi B
N.E.R.D & Future - 1000
Tee Grizzley & Lil Durk - WhatYo City Like
What So Not - Be Ok Again feat. Daniel Johns
AREA21 - Glad You Came
Jax Jones - Breathe feat. Ina Wroldsen
3LAU - Walk Away feat. Luna Aura
Bahamas - Way With Words
Devin Dawson - Asking for a Friend
Møme - Let’s Go feat. Mr. J. Medeiros
First Aid Kit - Fireworks
R3HAB & KSHMR - Islands
Pell - golden feat. VÉRITÉ
Nipsey Hussle - Rap Niggas
Robbie Williams - Ms Pepper
Bhad Bhabie - I Got It
Foreign Air - Chakra Daemon
NoMBe - Eden feat. Geneva White
Andy Grammer - Always
DJDS & Empress Of - Love
SKYGGE - In the House of Poetry feat. Kyrie Kristmanson
Pia Mia - Off My Feet
NERVO & Wolfpack - Like Air
Belle Mt - Loving You
Luke Bryan - Out Of Nowhere Girl
Sam Fischer - Getting Older
Slenderbodies - amnesia
The Fratellis - Stand up Tragedy
Jessie Reyez - Cotton Candy
BRÅVES - California
Baby Ariel - Aww
Black Veil Brides - Rebel Yell
Sam Smith - River (Recorded At RAK Studios, London)
Demi Lovato - I'll Be Home For Christmas (Recorded at Spotify Studios NYC)
Fifth Harmony - Can You See (Recorded at Spotify Studios NYC)
DMX - Rudolph the Rednose Reindeer feat. Divine Bars
Rostam - Fairytale of New York (Recorded at Spotify Studios NYC)Embed So Far Away (feat. Jamie Scott & Romy Dya) So Far Away (feat. Jamie Scott & Romy Dya) Martin Garrix;David Guetta;Jamie Scott;Romy Dya house