1 ContributorNew Music Tuesday 09/23/14 LyricsNiykee Heaton - Bad Intentions
Kiesza - Bad Thing
Kip Moore - Beer Money - Live From Soundcheck
Mapei - Blame It on Me
Jennifer Lopez - Booty
Jessie J - Burnin' Up
Jamestown Revival - California (Cast Iron Soul)
White Arrows - Can't Stop Now
Andrew McMahon in the Wilderness - Canyon Moon
Yellowcard - Crash the Gates
Lenny Kravitz - Dirty White Boots
LIGHTS - Don't Go Home Without Me
Blake Mills - Don't Tell Our Friends About Me
Kasabian - eez-eh
alt-J - Every Other Freckle
New Politics - Everywhere I Go (Kings and Queens)
Elle King - Ex's & Oh's
Prince - FUNKNROLL
Perfume Genius - Grid
Keys N Krates - Hypnotik - Original Mix
Kendrick Lamar - i
Big Sean - I Don't Fuck With You
The Drums - I Hope Time Doesn't Change Him
Rittz - In My Zone
Neulore - In The Orchard
Ryan Adams - Jacksonville - Paxam Single Series Vol. 2
Pentatonix - La La Latch
Lil Dicky - Lemme Freak
Megan Washington - Limitless
K. Michelle - Love 'Em All
Luke James - Love XYZ
Strange Talk - Morning Sun (Dillon Francis Remix)
Leonard Cohen - My Oh My
Rae Sremmurd - No Type
Tweedy - Nobody Dies Anymore
GRMLN - Numb
Missy Higgins - NYE
Elliphant - One More
Machinedrum - Only 1 Way 2 Know
Tweedy - Please Don't Let Me Be So Understood
Empires - Please Don't Tell My Lover
RL Grime - Reminder (feat. How To Dress Well)
Jon Bellion - Run Wild
Aphex Twin - s950tx16wasr10 [163.97][earth portal mix]
Nick Hakim - Sleep
LIGHTS - Speeding
Robin Schulz - Sun Goes Down (feat. Jasmine Thompson) - Radio Mix
Skrillex & Diplo - Take Ü There (feat. Kiesza)
The Rural Alberta Advantage - Terrified
SBTRKT - The Light
Bush - The Only Way Out
Mary J. Blige - Therapy
José González - This Is How We Walk On The Moon
Tove Lo - Thousand Miles
Paloma Faith - Trouble with My Baby
G-Eazy - Tumblr Girls - Live from Spotify SXSW 2014
Afrojack - Turn Up The Speakers
Logic - Under Pressure
CHVRCHES - Under The Tide
Jennifer Hudson - Walk It Out
alt-J - Warm Foothills
Imagine Dragons - Warriors
The New Basement Tapes - When I Get My Hands On You
Cymbals Eat Guitars - XREmbed Sun Goes Down (feat. Jasmine Thompson) - Radio Mix Prayer Robin Schulz;Jasmine Thompson german