2 ContributorsNovedades de Viernes 01/03/19 Lyrics[New Music Friday Latin]
Ximena Sariñana - Cobarde
Kany Garcia - Quédate (feat. Tommy Torres)
benny blanco - I Can’t Get Enough (benny blanco, Selena Gomez, J Balvin, Tainy)
Maluma - HP
Ivy Queen - Llego La Queen
Remmy Valenzuela - Mentiras
Carlos Vives - Si Me Das Tu Amor (feat. Wisin)
Lalo Ebratt - Déjate Querer (feat. Sebastian Yatra, Yera, Trapical Minds)
Lyanno - Pa' Que Vuelvas
Fuego - Good Vibes (Official Remix) (feat. Nicky Jam, De La Ghetto, Amenazzy, C. Tangana)
Sech - Solita (feat. Farruko, Zion & Lennox)
COASTCITY - Salvaje
Ximena Sariñana - No Sé (feat. Girl Ultra)
Brika - Distracted
Saak - La Solución
Nacho - Nadie Sabe
Gloria Trevi - Yo Soy Su Vida
Cultura Profética - Hasta la Noche (Ilegal) (Recorded at Spotify Studios NYC)
Ambar Lucid - Painted Red
Marissa Mur - Ojos Bengala
Femina - Resist (feat. Iggy Pop)
Technicolor Fabrics - Levitando
Fede Dorcaz - Un Pedacito (feat. ATL)
Myke Towers - Si Se Da (feat. Farruko)
J Alvarez - Enamórate (feat. Jowell & Randy)
GTA - Miénteme (Sak Noel Remix)
Ludmilla - Favela chegou (Ao vivo) (feat. Anitta)
Kaydy Cain - Algo Como Tu (feat. Los del Control)
Sari Cool - La Patrona (feat. DanDani)
Mitre - Tierra Mojada
Hello Seahorse! - Incendio
Combo Chimbita - Brillo Más Que El Oro (La Bala Apuntándome)
Elsa Y Elmar - Ojos Noche
María Mezcal - Baila Tristeza
Charlie Rodd - Soñar Contigo
Jackie Mendoza - Seahorse
DELLAFUENTE - Octava Maravilla
iZaak - Juguete (feat. DrefQuila & WC no Beat)
Solo Valencia - Cristal (feat. El Caribefunk)
Melissa Romero - Compleja Y Sencillamente
Samy y Sandra Sandoval - La Patrona (Remix) (feat. Sara Castro, Mc Th, I Nesta, Idrise)
Argüello - Pa' Donde Vamos (feat. Mik Mish, Feid)
WHATUPRG - SWISH
Mariah - Celos (feat. Myke Towers)
H Roto - Rally (feat. Duki, GARZI)
Macotea - Check (feat. Jim Jones)
Miss Caffeina - Prende
El Alfa - Tamo Open Yo (feat. Dj Kass)
Adrian Rodriguez - Como Tu Ninguna (feat. Victor Magan)
Lenier - Yo Tengo una Guitarra Que No Suena (DJ Unic Remix) (feat. El Taiger)
Lariba - Mejor no lo hagas
Asmir Young - Se Supone[Novedades Viernes España]
Ellie Goulding - Flux
Dani Fernández - Disparos
Martin Jensen - Nobody (feat. James Arthur)
Hard GZ - Exigencias
Summer Walker - Girls Need Love (with Drake) (Remix)
Juice WRLD - Hear Me Calling
Denom - Déjame volar
Tom Walker - Now You're Gone (feat. Zara Larsson)
Gesaffelstein - Blast Off (feat. Pharrell Williams)
Rita Ora - Only Want You (feat. 6LACK)
Lauv - i'm so tired... (MNEK remix) (feat. Troye Sivan)
Sergio Contreras - Amanecí bailando (feat. Manuel Delgado)
Hombres G - Confía en Mi
Jonas Brothers - Sucker
Matasvandals - Sigo Aquí (feat. Da Silva)
Rich The Kid - 4 Phones
Los Chikos del Maiz - Valerie Solanas (Stop Making Stupid People Famous)
Marwan - Los Restos de Esta Historia (feat. Iván Ferreiro) (feat. Ivan Ferreiro)
MARINA - Superstar
Jasmine Thompson - take care
Hozier - To Noise Making (Sing)
Mygal X - El Trato (feat. Mc Buseta)
Crystal Fighters - Runnin'
Solange - Stay Flo
Lil Skies - i
KSHMR - No Regrets (feat. Krewella) (feat. Yves V)
blackbear - HIGH1X
Roi Méndez - Plumas
Cookin Soul - Couldu
ELYELLA - Hola, ¿qué tal? (feat. Jero Romero)
Fuerza Nueva - Santo Dios (feat. Los Planetas, Niño de Elche)
CHILAX - Contigo (feat. Medina Kid)
Novo Amor - No Fun (feat. Gia Margaret)
NEIKED - Lifestyle (feat. Husky)
DORA - Saving Star[Novedades Viernes México]
David Bisbal - Tú Eres La Magia (Canción Original De La Película "El Parque Mágico")
Solange - Almeda
Carly Rae Jepsen - Now That I Found You
Bea Miller - it's not u it's me (feat. 6LACK)
Fobia - El Microbito (Pastel - En Vivo)
Los Caligaris - Olvidar (En Vivo Auditorio Nacional) (feat. Mariachi 2000)
Digitalism - Infinity
2 Chainz - Rule The World (feat. Ariana Grande)
G-Eazy - West Coast (feat. Blueface)
The Plastics Revolution - Cámara Lenta (feat. Santiago Casillas, Chimo)
Morrissey - It's Over
Weezer - I’m Just Being Honest
Foals - Sunday
The Drums - 626 Bedford Avenue
The Asteroids Galaxy Tour - Boy
Manu Negrete - Aguas de Marzo
Tierra Whack - CLONES
Nanpa Básico - Pulso & Sudor
Big Thief - UFOF
Yoke Lore - Beige (unburdened)
Bronko Yotte - Matanga
El Licenciado - Sucio (feat. $antana1000000)
Ali Masare - Hablando Claro
Agrupación Cariño - Tristeza[Novedades Viernes Colombia]
Omar Koonze - Mpha: Llegando Asi
Jeloz - Juntos
Saak - Karma
Sigrid - Sight Of You
Kiño - De Local (feat. Fidel Nadal)
Ruzto - Compay Certero
Doble Porcion - Receso Solo 3 (feat. Crudo Means Raw)
Emily Burns - Too Cool
Mansionair - Alibi
KH - Only Human (Radio Edit) (feat. Four Tet)
Vilamarea - Capulí (Remix) (feat. EVHA)
Viniloversus - Ultraviolenta
FEWS - Anything Else
Quemarlo Todo Por Error - Volar
Usted Señalemelo - Pastizal
Submarino - Intentar Conectar
Black Pop - Wasap
Bleepolar - Humano
LaTorre - Desventura
Nina Rodriguez - Destino
Juan Astronauta - Lonely (feat. Julia Adal, Killabeatmaker)
Cultura Profética - Love And Happiness (Recorded at Spotify Studios NYC)
Kevin Morby - No Halo
Roosevelt - Falling Back
Pond - TasmaniaEmbed I Can’t Get Enough (benny blanco, Selena Gomez, J Balvin, Tainy) I Can’t Get Enough (benny blanco, Selena Gomez, J Balvin, Tainy) benny blanco;Selena Gomez;J Balvin;Tainy electro