3 ContributorsNew Music Friday 05/08/20 LyricsAriana Grande - Stuck with U (with Justin Bieber)
Kehlani - Can I (feat. Tory Lanez)
Lil Tjay - Zoo York (feat. Fivio Foreign & Pop Smoke)
Arizona Zervas - 24
Lil Durk - 3 Headed Goat (feat. Lil Baby & Polo G)
Hailee Steinfeld - End this (L.O.V.E.)
Anson Seabra - Somewhere in Ann Arbor
NAV - Saint Laurenttt
Chris Brown - Go Crazy
Peter Manos - Tennessee
Lauv - Love Like That
Gryffin - Heavenly Father (feat. Noah Kahan) - Recorded at Electric Lady Studios, NYC
Sia - Saved My Life
Kim Petras - Malibu
OMB Bloodbath - Dropout (with Maxo Kream)
Audrey Mika - Just Friends
Arlo Parks - Black Dog
Lonely God - Sunday
Charli XCX - i finally understand
Migos - Taco Tuesday
UMI - Introspection
Hayley Williams - Pure Love
NOTD - I Don't Know Why
A.CHAL - Hollywood Love (feat. Gunna)
RMR - DEALER (feat. Future & Lil Baby)
Roy Woods - I Feel It
Yebba - Distance
Weezer - Hero
Bryce Vine - Problems (feat. Grady)
SEBASTIAN PAUL - IMPATIENT
PUBLIC - Honey In The Summer
Lianne La Havas - Paper Thin
Jesse & Joy - Alguien Más
BRELAND - Horseride
Daniyel - MOM
Moneybagg Yo - Me Vs Me
E-40 - Up or Down
Little Simz - might bang, might not
Easy Life - peanut butter
Salt Cathedral - a lifetime with you
Chelsea Collins - 07 Britney
Buju Banton - Memories
MarMar Oso - Love Songs (feat. Luh Kel)
lovelytheband - i should be happy
Ben Platt - So Will I
Moby Rich - friends*
Tim McGraw - I Called Mama
Clinton Kane - i don't want to watch the world end with someone else
L Devine - Don't Say It
Styles P - Time
Tm88 - Blue Jean Bandit
Bankrol Hayden - Rich Bitch
Kyd the Band - Heartbreak Anthem
Matoma - Let It Go (feat. Anna Clendening)
RAC - Next To You
Conor Matthews - Way Out
JP Cooper - Little Bit Of Love
Cali Y El Dandee - Locura
Yella Beezy - Raccs
Lil Loaded - Raw Shit
Da Great Ape - Quarter Brick (feat. Rick Ross)
AViVA - HYPNOTIZED
Chord Overstreet - What You Need
IU - eight(Prod.&Feat. SUGA of BTS)
Trella - Waiting Games
Becca Mancari - First Time
Oscar Welsh - S.A.D
Jacob Banks - Like You'll Never See Me Again
Quando Rondo - Get Down
Jessie Ware - Save A Kiss - Single Edit
Greyson Chance - Honeysuckle
Josie Dunne - Lost
Cold War Kids - 1 x 1 (feat. Wesley Schultz)
Jordan Davis - Almost Maybes
Danielle Bradbery - Never Have I Ever
Joshua Speers - Can I Fall in Love with a Broken Heart
Brandon - Weep
Caleb Giles - Diamonds
Queen Key - Take Yo Man
Jacob Latimore - Fashion
Ian Isiah - N.U.T.S.
Wafia - Pick Me
Ruben - Burn Down This Room
somegirlnamedanna - kitchen table
Zach Bryan - Elisabeth
Rhye - Beautiful
Buscabulla - Nydia
Blake Mills - Money Is The One True God
Crisaunt - Supplier!
sophie meiers - as good as it gets
Lo Lind - Fake Friends
Caro - When All My Friends Move Away
Lakeview - Rain Down
Kathleen - Seven Miles
Philmon Lee - Memories
Jutes - Girls
The Growlers - Dream World
chillpill - FUCK THE CLUB (feat. GOLDN)
Delly - No Games
Mae Muller - I Don't Want Your Money
The Aces - My Phone is Trying to Kill MeEmbed Zoo York (feat. Fivio Foreign & Pop Smoke) State of Emergency Lil Tjay;Fivio Foreign;Pop Smoke r-n-b