2 ContributorsNew Music Friday 12/13/19 LyricsHarry Styles - Treat People With Kindness
Alec Benjamin - Mind Is A Prison
Lil Uzi Vert‚ÄÖ-‚ÄÖFutsal Shuffle 2020
Dua‚ÄÖLipa - Future Nostalgia
KAYTRANADA - The‚ÄÖWorst In Me
Russ - NIGHTTIME (Interlude)
Stormzy - Audacity (feat. Headie One)
NLE Choppa - Famous Hoes
Usher - Don't Waste My Time (feat. Ella Mai)
Ti√´sto - BLUE
Harry Styles - Falling
RAYE - Please Don‚Äôt Touch
Anson Seabra - Trying My Best
Kesha - Resentment (feat. Sturgill Simpson, Brian Wilson & Wrabel)
Blake Shelton - Nobody But You (Duet with Gwen Stefani)
Ava Max - Salt
Travis Barker - Gimme Brain
YoungBoy Never Broke Again - Dirty Iyanna
Sofia Carson - I Luv U
Meghan Trainor - Evil Twin
Louis The Child - Here Comes A Feeling (with Naomi Wild & Couros)
070 Shake - Under The Moon
Jake Paul - These Days
Rotimi - In My Bed
Macklemore - It's Christmas Time (feat. Dan Caplen)
Smokepurpp - What I Please (feat. Denzel Curry)
Only The Family - Career Day (with Lil Durk feat. Polo G)
Free Nationals - Gidget
Lolo Zoua√Ø - Chain
Dreamer Boy - Puppy Dog
Audrey Mika - Change Your Heart
Grimes - 4√ÜM
Tommy Genesis - Bricks
Arcangel - Sigues Con El
Diplo - On My Mind
Lil Tjay - Go In
Mulatto - No Panties
Don Toliver - Can't Feel My Legs
Bantu - Gucci Cranberry
Delacey - No One's Gonna Ever Love U
Carly Rose - warned you
Sam Fender - All Is On My Side
The Voidz - Did My Best
MGMT - In The Afternoon
Moses Sumney - Polly
zack villere - A Feeling
Arin Ray - The Get Down
YFN Lucci - Shake Sumn (feat. City Girls & Yo Gotti) - Bonus Track
Blacc Zacc - Time Again
Hayley Kiyoko - runaway
Casper Magico - La Mas Linda
Jonas Blue - Billboard
OMI - I Want You
Parmalee - Just the Way
Alec King - 7PM
Gabrielle Aplin - Magic
Felly - Wood v2
Nappy - Aye üêö
G Herbo - Remember
Kamaiyah - Still I Am
Victor Internet - I KNO V3
Alec Wigdahl - Dog Videos
Okay Kaya - Asexual Wellbeing
Xie - Jungle Juice
Paloma Mami - Mami
Jay Sean - Lonely
Pop Smoke - 100k On A Coupe (feat. Calboy)
K CAMP - Ice Cold
DZ - R&B All Night
Lil West - Pay Me
Jay Critch - Dreams In A Wraith
Pouya - 50 Reasons Why
Drama Relax - On The Side
Cub Sport - Hearts in Halves
StayLoose - Won't Look Back (feat. Soundr)
cehryl - Hide n Seek
Yumi Zouma - Right Track / Wrong Man
Salt Cathedral - CAVIAR
Leven Kali - Homegirl (feat. Smino & Topaz Jones)
City Morgue - DRAINO (feat. Denzel Curry)
TLE Cinco - Fix The Mic
BEXEY - ETERNAL FLOW
ZZ Ward - Sex & Stardust
The Blue Stones - Grim
Filmore - Busy
The Score - Bulletproof (with XYL√ò)
Poppy - Fill the Crown
TNGHT - Clever Pants
Yellow Claw - El Terror (feat. Jon Z & Lil Toe)
Riton - Mr Todd Terry
HEALTH - DELICIOUS APE
Teejayx6 - Reader & Writer
Bad Gyal - Zorra
Inayah - Real Love
Elujay - Black TeeEmbed Nobody But You (Duet with Gwen Stefani) Fully Loaded: God's Country Blake Shelton;Gwen Stefani country