2 ContributorsNew Music Friday 5/14/21 LyricsJ. Cole - a m a r i
Olivia Rodrigo - good 4 u
Nicki Minaj - Seeing Green (with Drake & Lil Wayne)
Migos - Straightenin
Internet Money - His & Hers (feat. Don Toliver, Lil Uzi Vert & Gunna)
Katy Perry - Electric
Jorja Smith - Bussdown (feat. Shaybo)
Joy Oladokun - Bigger Man (with Maren Morris)
21 Savage - Emergency (feat. Gunna & Young Thug)
YoungBoy Never Broke Again - White Teeth
J. Cole - 9 5 . s o u t h
Jelani Aryeh - From These Heights
Martin Garrix - We Are The People (feat. Bono & The Edge) - Official UEFA EURO 2020 Song
Tones And I - Won't Sleep
T-Pain - I Like Dat
Surfaces - Next Thing (LovÐµrboy)
Bella Poarch - Build a Bitch
Dixie - FUCKBOY
Alaina Castillo - pocket lockÐµt
Skrillex - Too Bizarre (with Swae Lee & Siiickbrain)
Kodak Black - Z Look Jamaican
J. Cole - p r i d e . i s . t h e . d e v i l (with Lil Baby)
Leon Bridges - Motorbike
St. Vincent - Down
Cautious Clay - Wildfire
Daya - The Difference
Sam Fischer - Simple
Sarcastic Sounds - say goodbye
Lil Skies - Ice Water (feat. Trippie Redd)
Rowdy Rebel - 9 Bridge
Sabrina Claudio - For The Time Being - Interlude
Paris Texas - PACK 4 DA LOW
AUDREY NUNA - Blossom
Noah Kahan - Part of Me
Lukas Graham - Happy For You
Lele Pons - Al Lau
Wallice - Off the Rails
fanclubwallet - What's Up
bbno$ - my oh my
The Black Keys - Poor Boy a Long Way From Home
2KBABY - Great White ðŸ•’
UPSAHL - Douchebag
renforshort - fall apart (with glaive)
Claire Rosinkranz - Frankenstein
Cavetown - Ur Gonna Wish U Believed Me
Alan Walker - Believers
Alan Jackson - Back
Laine Hardy - Memorize You ðŸ•’
SHAED - High Dive - Lewis Del Mar Version
Au/Ra - Bite Marks
Jenevieve - Eternal
Leah Kate - Boy Next Door
AJ Mitchell - GROWING PAINS
Piâ€™erre Bourne - Groceries
TheHxliday - MiSSed Calls
Calboy - Ten Toes Down
Young Nudy - 2Face (feat. G Herbo)
Danny Ocean - Besarnos de cero
Cash Cash - 42
Bryce Vine - Blame It On Me
Forrest Nolan - Summer Vibe
Allison Ponthier - Harshest Critic
blackwinterwells - OMEN
BabyJake - Funny Thing About Love (with Bipolar Sunshine)
Larry June - Wait On Me ðŸ•’
Taleban Dooda - More Than Average ðŸ•’
Big Jade - Pressed (feat. OMB Bloodbath) ðŸ•’
Ambar Lucid - Get Lost In The Music
Sleater-Kinney - Worry With You
Elaine - Right Now
ELENA ROSE - Pimienta ðŸ•’
Bianca Rose - Edge of a Fickle Flame
Loud Luxury - Red Handed
Justin Quiles - Loco
Kamal. - lose
Ellise - Chaotic
Winnetka Bowling League - barcelona
Willie Jones - Down by the Riverside
Zhavia Ward - Big Girl$ Don't Cry
Joseph Black - mad at me
Bizzy Banks - City Hot
KA$HDAMI - Dior
Rain Radio - Talk About ðŸ•’
Sam Ezeh - Sapphire Alley
Current Joys - Breaking the Waves
Oscar Lang - Are You Happy?
Mob Rich - Funeral ðŸ•’
Ayron Jones - Take Your Time ðŸ•’
Flatland Cavalry - Some Things Never Change
Livingston - Atlas
RYMAN - Crying Wolf
clide - can't give back your love
Josh Golden - I Love You, But..
TiaCorine - Luigi ðŸ•’
Enchanting - Freaky Deaky (feat. Coi Leray) ðŸ•’
Young Devyn - Act Bad
Thalia - No Te Vi
MK xyz - One Time
LAUREL - Let GoEmbed We Are The People (feat. Bono & The Edge) - Official UEFA EURO 2020 Song We Are The People (feat. Bono & The Edge) [Official UEFA EURO 2020 Song] Martin Garrix;Bono;The Edge house