1 ContributorNew Music Friday UK 11/10/19 LyricsHarry Styles - Lights Up
YUNGBLUD - original me (feat. dan reynolds of imagine dragons)
MEDUZA -‚ÄÖLose‚ÄÖControl
Gerry Cinnamon -‚ÄÖSun Queen
James Arthur - You (feat.‚ÄÖTravis Barker)
Cigarettes After Sex - Falling In Love
Sidhu Moose Wala - 47 (feat. Stefflon Don)
Camila Cabello - Easy
Wretch 32 - 10/10
Michael Kiwanuka - Hero
Plested - The Least That I Could Do
Ella Henderson - Young
Kash Doll - How It‚Äôs Done (with Kim Petras, ALMA, Stefflon Don) - From "Charlie's Angels (Original Motion Picture Soundtrack)"
Caribou - Home
Kara Marni - Caught Up

The Wha - 40 Odd Years

Franc Moody - Terra Firma

AWA - Comfortable

Nil√ºfer Yanya - H34T RISES
FKA twigs - home with you

TSHA - Me You - Edit
A R I Z O N A - Problems
Elbow - My Trouble
88rising - Walking (feat. Swae Lee & Major Lazer)
BENEE - Find an Island
Jaz Karis - Summer Story
Oscar Scheller - Confidence

Self Esteem - Rooms - Bonus Track

The Black Eyed Peas - RITMO (Bad Boys For Life)
Sam Tompkins - Faded

Balcony - Inside Out

Olivia Dean - Password Change
James Blunt - I Told You

Sharna Bass - Worth It

Green Day - Fire, Ready, Aim
Bouncer - Winner
Cher Lloyd - M.I.A

Sondr - So Blue

French Montana - Twisted (feat. Logic & A$AP Rocky)
Chris Lorenzo - Here Kitty
R3HAB - Exhale
Christian Alexander - Lemonade
Kitt Philippa - Moth

Mansionair - Easier (feat. SHAED)
Marian Hill - like u do
Poundz - Opp Thot
SYML - Symmetry

Arctic Lake - Cold Hands
The Pale White - Swim for Your Life

Roddy Ricch - Big Stepper

Celaviedmai - For Me

Geowulf - My Resignation
EDEN - untitled
SebastiAn - Sober

Shift K3Y - Get Low üêö
Manu Crooks - Above Water

ELKAE - Conflictus
Riva Starr - Feel It
D'One - Never Over
DJ Seinfeld - Please Slow Down
iris - cotton candy

Panda Bear - playing the long game
Jack Larsen - Vanity
Bonnie "Prince" Billy - In Good Faith
Toby Johnson - Boutique Taberna
Zubi - Make It Mine
Pat Lagoon - Shadow

Big Thief - Two Hands
Dan Owen - Beauty in Disaster

Cam Wild - Crazy Life
Afro B - Condo üêö
Julien Chang - Moving Parts üêö
Louis Berry - Molly Malone

1991 - Full Send
LOGUOS - You Can Feel My Love
Babeheaven - Cat Dance
Ka√© - Can't Love Me
ili - plastic knife üêö
Lost + Found - Ghosted
DJ S.K.T - Certi (Move Your Body)
Girl Ray - Girl
Madism - Tried to Love
Yann Tiersen - Monochrome - Portrait Version
Harrison - Freak Like Me (feat. Melody Thornton)

Kim Gordon - Hungry BabyEmbed Feel Your Body Feel Your Body Shift K3Y deep-house