13 ContributorsJanuary 2019 Singles Release Calendar Lyrics1/1
Anuel AA - "Te Boté (RHLM Version)"
Chaka Khan - "Hello Happiness"
DaBaby - "Walker Texas Ranger"
Deniro Farrar - "Trap Hall Of Fame" ft. Jayway Sosa
Duki - "Ballin'"
Duki - "LeBron"
Noname - "Song 31"
Paul McCartney - "Get Enough"
1/2
IRIS - "Hibernation"
Unlike Pluto - "No Rainbows in the Desert"
1/3
Bring Me The Horizon - "medicine"
Christina Perri - "a thousand years (lullaby)"
Emeli Sandé - "10,000 Enemies"
Lil Xan - "Watch Me Fall"
Xeno Carr - "For Real"
1/4
3LAU - "Would You Understand"
Aaron Watson - "Kiss That Girl Goodbye"
Agustín Casanova - "Bye Bye"
Backstreet Boys - "No Place"
benny blanco, Calvin Harris & Miguel - "I Found You / Nilda's Story"
Black Pistol Fire - "Level"
Charles Fauna - "No One Else"
Chris Brown - "Undecided"
Chris Young - "Raised on Country"
D'Angelo - "Unshaken"
Danielle Bradbery - "Psycho (Yours Truly: 2018)"
Future - "Crushed Up"
Grizfolk - "Spoonful"
Hardwell - "Being Alive" ft. JGUAR
Hot Flash Heat Wave - "Sky So Blue"
James Hersey & Jeremy Loops - "My People"
Lil Pump - "Butterfly Doors"
Lizzo - "Juice"
Lorna Shore - "Darkest Spawn"
Luke Christopher - "IT'S ALL YOURS"
Mark Diamond - "Steady"
Mark Ronson - "Nothing Breaks Like a Heart (Acoustic Version)" ft. Miley Cyrus
MIKA - "Sound of an Orchestra"
Mike Posner - "Move On"
Mineral - "Your Body Is the World"
MISSIO - "Rad Drugz"
Rhys Lewis - "Better Than Today"
Robokid - "17"
ROZES - "Halfway There"
Seven Lions, Wooli & Trivecta - "Island"
Shallow the Sun - "Upon the Water"
Teddy Robb - "Really Shouldn't Drink Around You"
Temmpo - "Cassette"
The Regrettes - "Don't Stop Me Now"
Yakuza - "Chola / Madonna"
1/5
Owl Vision - "Zepulchre"
Ozuna - "Baila Baila Baila"
1/7
Alec Benjamin - "Let Me Down Slowly (Remix)" ft. Alessia Cara
Imagine Dragons - "Believer (Remix)" ft. Lil Wayne
KYLE - "Playinwitme (Jay Park Remix)" ft. Jay Park
The Chemical Brothers - "MAH"
1/8
Catfish and the Bottlemen - "Longshot"
Mark Morton - "Cross Off" ft. Chester Bennington
Roy Kinsey - "Apple Care"
Sharon Van Etten - "Seventeen"
1/9
Billie Eilish - "WHEN I WAS OLDER"
Boogie - "Silent Ride"
Future - "Jumpin on a Jet"
Halsey & Juice WRLD - "Without Me (Remix)"
Jake Hill - "Nyx"
Lana Del Rey - "hope is a dangerous thing for a woman like me to have - but i have it"
Melii - "HML" ft. A Boogie wit da Hoodie
Unlike Pluto - "Riptide"
wifisfuneral & Robb Bank$ - "Can't Feel My Face"
1/10
American Authors - "Stay Around"
Andrea Valle - "No More"
Betty Who - "I Remember"
Bhad Bhabie - "Babyface Savage" ft. Tory Lanez
COIN - "I Want It All"
DJ TOPGUN & Ant Beale - "Ring Bells"
Farruko - "Paz" ft. El Micha
Gary Clark Jr. - "This Land"
Grey - "Want You Back" ft. LÉON
Kehlani - "Nights Like This" ft. Ty Dolla $ign
SOAK - "Knock Me Off My Feet"
Westlife - "Hello My Love"
1/11
Big Wild - "City of Sound"
Calvin Harris & Rag'n'Bone Man - "Giant"
Charli XCX & Troye Sivan - "1999 (Stripped)"
CG5 - "Evil Team" ft. OR3O
CupcakKe - "Squidward Nose"
Danny Gokey - "Haven't Seen It Yet"
Gesaffelstein & The Weeknd - "Lost in the Fire"
Goonew - "Chanel"
iLoveMakonnen - "Spendin'" ft. Gucci Mane
Jacquees - "You (Remix)" ft. Blueface
Jaira Burns - "Numb"
Khalid - "Saturday Nights REMIX" ft. Kane Brown
Jowell & Randy - "Dile la Verdad" ft. Manuel Turizo
Juanes - "La Plata" ft. Lalo Ebratt
Lauren Jauregui - "More Than That"
Lil Duval - "Pull Up" ft. Ty Dolla $ign
Luh Soldier - "Contraband"
Luke Christopher - "CAN'T LET GO"
Maikel Delacalle - "Amuleto (Remix)" ft. Kevin Roldán
Maldy - "Tiempo de Vernos" ft. J Alvarez
Monica - "Commitment"
Melendi - "El Cielo Nunca Cambiará"
Natti Natasha - "Pa' Mala Yo"
Picture This - "If You Wanna Be Loved"
Polimá Westcoast - "Live Fast Die Young"
Rudimental - "Scared of Love" ft. Ray BLK & Stefflon Don
Sam Smith & Normani - "Dancing with a Stranger"
Soldier Kidd - "Survivin'"
WALK THE MOON - "Timebomb"
Yung Bleu - "Time To Myself"
Zhavia Ward - "Candlelight (Remix)" ft. Jeremih
1/13
30 Glick - "Trap Phone"
1/14
Jai Wolf - "Lose My Mind" ft. Mr Gabriel
Jai Wolf - "Telepathy"
The Killers - "Land of the Free"
Take A Daytrip - "Stressed" ft. Octavian
Toquel - "THL" ft. Mad Clip
Yandel - "Sumba Yandel"
Mike Posner – "Noah's Ark"
1/15
BoatHouse & Ajani Jones - "APEX"
Fly Rich Double - "Big Boom"
Hozier - "Almost (Sweet Music)"
Jade Bird - "I Get No Joy"
K Camp - "Switch"
Karol G & Anuel AA - "Secreto"
LAMB$ - "Fighting Demons" ft. Lil Uzi Vert
Mansionair - "Shadows"
Tyler Fontaine - "Let's Go!"
Whitechapel - "Third Depth"
1/16
DJ Scheme - "Hey Mister" ft. Ski Mask the Slump God
HRVY & Danna Paola - "So Good (Remix)"
Mustard & Migos - "Pure Water"
Rynx - "Hold On" ft. Drew Love
Unlike Pluto - "Villain of My Own Story"
Wild Nothing - "Blue Wings"
1/17
Chloe Adams - "Young Forever"
FRENSHIP - "Wanted a Name" ft. Yoke Lore
Inna - "Sin Ti"
Kerli - "Better"
LSD - "Genius (Lil Wayne Remix)" ft. Lil Wayne
Maren Morris - "Girl"
Minke - "Too Late"
Sean Paul - "Shot & Wine" ft. Stefflon Don
Sigrid - "Don't Feel Like Crying"
Why Don't We - "BIG PLANS"
1/18
Ariana Grande - "7 rings"
Backstreet Boys - "Breathe"
Becky G - "LBD"
Dan Caplen - "Love Me the Same"
Dean Lewis - "7 Minutes"
Dreezy - "RIP Aretha"
Elle Varne - "Pour Me" ft. Wale
Farruko - "Nadie"
G Herbo - "Up It"
Gloria Trevi - "Vas A Recordarme"
Greeicy - "Ganas"
Grimes - "We Appreciate Power (BloodPop® Remix)" ft. HANA
INNA - "Sin Ti"
India.Arie - "What If"
James TW - "You & Me"
Jesper Janset - "Red Eyes"
J-E-T-S - "PLAY" ft. Mykki Blanco
Karlae - "RIXH" ft. Rich the Kid
Khao - "Done With Her" ft. Tabius Tate, YBN Nahmir, Lil Baby & Gucci Mane
Lauren Aquilina - "If Looks Could Kill"
lil aaron - "Dark Matter"
Lil Skies - "Real Ties"
Logic - "Keanu Reeves"
Luke Christopher - "HEART CLUB"
Mabel - "Don't Call Me Up"
MAJ - "Come Here"
ohtrapstar - "Who TF Is U?"
Old Dominion - "One Man Band"
Plies - "Drip 4 Sale"
R3HAB - "BAD!"
RKM & Ken-Y - "No Reciclo Amores"
Sam Feldt & Kate Ryan - "Gold"
Sebastián Yatra - "Un Año" ft. Reik
Sky - "Bajo Cero" ft. J Balvin, Jhay Cortez & MadeinTYO
Slushii - "Never Let You Go" ft. Sofia Reyes
Sofi Tukker & ZHU - "Mi Rumba"
Terror Jr. - "Pretty"
The Aston Shuffle & Fabich - "Stay"
Transviolet & The Swoons - "Lost Frequency"
Vicetone - "Fences" ft. Matt Wertz
Xan Griffin - "Butterfly Effect"
Young the Giant - "Superposition (Reprise)"
Yung Pinch - "Nightmares" ft. Lil Skies
Zeds Dead & Delta Heavy - "Lift You Up"

1/19
Desiigner - "RIICH" ft. Dave East
ohtrapstar - "i live once"
Spiffy Global & Hoodrich Pablo Juan - "Red Neck"
1/20
Almighty - "Fluye"
1/21
Drax Project - "Woke Up Late (Remix)" ft. Hailee Steinfeld

1/22
Bring Me The Horizon - "mother tongue"
Dido - "Give You Up"
League of Legends - "Awaken"
What So Not - "We Can Be Friends" ft. Herizen
Wiley, Stefflon Don & Sean Paul - "Boasty" ft. Idris Elba

1/23
American Football - "Uncomfortably Numb" ft. Hayley Williams
Gus Dapperton - "My Favorite Fish"
Injury Reserve - "Jawbreaker" ft. PRO TEENS & Rico Nasty
J. Cole - "Middle Child"
Lil Nas X - "BANZUP'"
Lolo Zouaï - "Jade" ft. Blood Orange
Lolo Zouaï - "Lose Myself"
Luis Fonsi - "Sola"
Luis Fonsi - "Sola (English Version)"
Soulja Boy - "Cut Dat Check"
T-Pain - "Getcha Roll On" ft. Tory Lanez
Tyga, G-Eazy & Rich The Kid - "Girls Have Fun"
Unlike Pluto - "Misdiagnosed"
Yung Trench - "I Don't Wanna Stay"
1/24
AURORA - "Animal"
Daddy Yankee - "Con Calma"
Dua Lipa - "Swan Song"
Florence + The Machine - "Haunted House"
Florence + The Machine - "Moderation"
GoldLink - "Got Muscle"
ITSOKTOCRY - "JIRACHI"
Jenny Lewis - "Red Bull & Hennessy"
Lauv & Troye Sivan - "i'm so tired..."
Vampire Weekend - "Harmony Hall"
Vampire Weekend - "2021"
1/25
Ashley Tisdale - "Love Me & Let Me Go"
Baby Goth - "Mary"
Big Data - "Unglued"
Blueface - "Thotiana (Remix)" ft. YG
Call Me Karizma - "Monster (Under My Bed)"
Dillon Francis & Alison Wonderland - "Lost My Mind"
Grace Carter - "Heal Me"
Hunter Hayes - "Heartbreak"
ILLENIUM - "Crashing" ft. Bahari
Kassi Ashton - "Violins"
Lil Toe - "B.O.M.T"
Lisa Cimorelli - "Italy"
Little Mix - "Think About Us (Remix)" ft. Ty Dolla $ign
Luke Christopher - "AGAINST ME"
M-22 - "White Lies"
Maxo Kream - "Meet Again"
Mike Williams - "I Got You"
Nicky Romero & Olivia Holt - "Distance"
PRETTYMUCH - "Blind"
Rockie Fresh - "Must Be" ft. Chris Brown
Stephen Puth - "Sexual Vibe (Acoustic)"
Tori Kelly - "Change Your Mind"
Two Friends - "Take It Off"
Vybz Kartel - "Come Home"
Ward Thomas - "It's Not Just Me"
X Ambassadors - "BOOM"
Yo Gotti - "Put A Date On It" ft. Lil Baby
Zacari - "Don't Trip"
1/28
Don Q - "Is This Ya King (Tory Lanez Diss Pt. 2)"
lil keyu - "Pakkman"
The Mountain Goats - "Younger"
Tory Lanez - "Don Queen (Don Q Diss)"
YBN Cordae - "Locationships"
1/29
DreamDoll - "On Ya Head (Tory Lanez Diss)"
Jarryd James - "Slow Motion"
Yung Lean - "Creep Creeps"
1/30
AJR - "100 Bad Days"
Alec Benjamin - "Let Me Down Slowly" (Spotify Singles)
Alec Benjamin - "Stan"
Aries - "SANTA MONICA"
Billie Eilish - "bury a friend"
Unlike Pluto - "Yes Offense"
Yung Trench - "ALL BLACK"
1/31
Ally Brooke - "Low Key" ft. Tyga
A$AP Twelvyy - "Child's Play"
Bhad Bhabie - "Bestie" ft. Kodak Black
Don Diablo - "You Are Not Alone" feat. Kiiara
Galantis - "Bones" ft. OneRepublic
Lil Peep & iLoveMakonnen - "I've Been Waiting" ft. Fall Out Boy
The Score - "Dreamin" ft. blackbearEmbed Without Me (with Juice WRLD) Without Me (with Juice WRLD) Halsey;Juice WRLD electro