1 ContributorNew Music Friday 4/16/21 LyricsYoung Stoner Life - Solid (feat. Drake)
Regard - You
girl in red - You Stupid Bitch
Moneybagg Yo - GO! (with BIG30)
iann dior - shots in the dark
Bebe Rexha - Sabotage
Loui - Talkin' Bout (feat. Saweetie)
IDK - SHOOT MY SHOT
Kygo - Gone Are The Days (feat. James Gillespie)
Julia Michaels - Love Is Weird
Fred again.. - Angie (Iâ€™ve Been Lost)
Sebastian Yatra - Pareja Del AÃ±o
Spinabenz - Who I Smoke
Toosii - what it cost
Queen Naija - Passionate
Andra Day - Phone Dies
Tommy Newport - Stargazer (with EARTHGANG)
Emotional Oranges - Down To Miami (with Becky G)
JAWNY - Best Thing
London Grammar - Lord It's a Feeling
Cautious Clay - Karma & Friends
Thomas Rhett - Country Again
Greta Van Fleet - Built By Nations
MARINA - Purge The Poison
carolesdaughter - Trailer Trash
EKKSTACY - i want to be by your side (feat. herhexx)
daine - boys wanna txt (feat. ericdoa)
Sleepy Hallow - 2055
Dave - Titanium
AJ Tracey - Little More Love
$uicideboy$ - NEW PROFILE PIC
Sinead Harnett - Hard 4 Me 2 Love You
Ashley Kutcher - If I Could
Ruth B. - Situation
Eric Church - Bunch Of Nothing
LoveLeo - BUZZCUT (feat. blackwinterwells)
Sueco - SOS (feat. Travis Barker)
ILOVEMAKONNEN - Whoopsy
Nebu Kiniza - Questions (feat. Future)
Boza - Ella
Reece - Down Goes Frazier
Dua Saleh - signs
Paris Texas - FORCE OF HABIT
BabyJake - Do I Fit In Your Shoes? ðŸ•’
Babygirl - Million Dollar Bed ðŸ•’
Baby Queen - Dover Beach
BeatKing - Keep It Poppin (feat. Ludacris & Queendom Come) ðŸ•’
Sech - Sal y Perrea
Two Feet - Flatline
Aidan Bissett - Communication
Bennett Coast - Deep End
Lucy Dacus - Hot & Heavy
Lord Huron - Long Lost
Tim McGraw - Cuttinâ€™ Onions
Brian Kelley - Beach Cowboy
The Black Keys - Crawling Kingsnake - Edit
dempsey hope - on my mind
WizTheMc - Catch Me
Big Scarr - Ballin In LA (feat. Gucci Mane & Pooh Shiesty)
Conway the Machine - Scatter Brain (feat. Ludacris & JID)
EST Gee - Lick Back ðŸ•’
Carlos Vives - CanciÃ³n Bonita
Steve Aoki - Aire
Sam Gellaitry - Duo
Annika Wells - Love Sucks
Emma Oliver - Do It All Again ðŸ•’
Kate Stephenson - Exless
Bino Rideaux - Incredible (feat. Drakeo the Ruler) ðŸ•’
Tee Grizzley - Never Bend Never Fold
Godfather of Harlem - Been To War (feat. Swizz Beatz, DMX & French Montana)
Lil Poppa - A.M. Flights (feat. Toosii)
easy life - skeletons
JosÃ© GonzÃ¡lez - Visions
Matilda Mann - Doomsday
Chet Faker - Whatever Tomorrow
Bianca Rose - Skin
SYML - DIM
Walk Off the Earth - Anthem
Leah Nobel - The Ones That Make It
LAUREL - You're The One
Grace VanderWaal - Repeat
sammy rash - try to try
Tom The Mail Man - Taking Over
Kenny Mason - Much Money (feat. Freddie Gibbs)
ALLBLACK - Ego
The Offspring - This Is Not Utopia
Oscar Lang - Stuck
ONE OK ROCK - Renegades
The Struts - Low Key In Love (with paris jackson)
Shungudzo - White parents
Tirzah - Send Me
Porsh Bet$ - Peanut Butter
Moe - Can't Help It (feat. Hotboii)
Johnny Goth - These Days R Mine
Julian Lamadrid - 15 Minutes
Maia Wright - Break Her Heart
BXB LOVE - matrix
Vince Ash - RL Jumpsuit
aroomfullofmirrors - RAWAR
Zaytoven - All My Guys (feat. Lil Yee & ZayBang)Embed Scatter Brain (feat. Ludacris & JID) La Maquina Conway the Machine;Ludacris;JID r-n-b