3 ContributorsNew Music Friday 1/10/20 LyricsSelena Gomez - Rare
Future - Life Is Good (feat. Drake)
Halsey - You should be sad
Mac Miller - Good News
Megan Thee Stallion - Diamonds
Khalid - Eleven
Tame Impala - Lost In Yesterday
Celeste - Stop This Flame
Lil Baby - Sum 2 Prove
Selena Gomez - Vulnerable
Conan Gray - The Story
Nicky Jam - Muévelo
070 Shake - Guilty Conscience
Mura Masa - Teenage Headache Dreams (with Ellie Rowsell)
Georgia - 24 Hours - Edit
John Legend - Conversations in the Dark
Sia - Original (from Dolittle)
Selena Gomez - Crowded Room (feat. 6LACK)
Moneybagg Yo - Protect Da Brand (feat. DaBaby)
Alicia Keys - Underdog
Ozzy Osbourne - Ordinary Man (feat. Elton John)
J Balvin - Morado
Static & Ben El - Further Up (Na, Na, Na, Na, Na) (feat. Pitbull)
Robin Schulz - In Your Eyes (feat. Alida)
Shallou - Older
Quinn XCII - Two 10s
Orion Sun - Ne Me Quitte Pas (Don't Leave Me)
Leyla Blue - Peppa Pig (Prod. Y2K)
Sam Feldt - 2 Hearts (feat. Gia Koka)
Carnage - Hella Neck
The Blaze - Somewhere
Kevitch - Sunrise
Lane 8 - Road
Becky Hill - Better Off Without You (feat. Shift K3Y)
SHY Martin - Slow
Ethan Gruska - Enough for Now (feat. Phoebe Bridgers)
Gabby Barrett - Hall of Fame
Devon Gilfillian - The Good Life
T.R.U. - Virgil Discount
TLE Cinco - Fastlane (feat. Clever)
Baby Goth - Afterparty
Amindi - Love Em Leave Em
Jay Menez - Solo (with Rauw Alejandro)
Kodaline - Wherever You Are
EDEN - isohel
Easy Life - Dead Celebrities
The Big Moon - Barcelona
chloe moriondo - Kindergarten
Olivia Rodrigo - Breaking Free - Nini, Ricky & E.J. Version
Nightly - the movies
brando - Look Into My Eyes
ripmattblack - You Love It!
Key Glock - Look At They Face
Royal & the Serpent - MMXX
Beach Bunny - Cloud 9
Moses Sumney - Me in 20 Years
Tennis - Need Your Love
gnash - hungover & i miss u
Artists for Peace and Justice - Under the Supermoon
Marcus King - Beautiful Stranger
Caitlyn Smith - Long Time Coming
Winona Oak - Control
Whethan - Stay Forever (feat. STRFKR)
Quando Rondo - Blue Opps
Aly Ryan - You Ain't Him
Nodis - Missed Calls, Broken Hearts
Noah Neiman - Hard
SAYGRACE - Loyal
Caroline Rose - Feel The Way I Want
flora cash - You Love Me
Little Big Town - Nightfall
Nathaniel Rateliff - And It's Still Alright
Alexandra Savior - But You
Dexter - Answer to Love
Elley Duhé - MIDDLE OF THE NIGHT
Now United - Let Me Be The One
Gavin Haley - Nowhere
guardin - alive
Grouplove - Deleter
Joywave - Half Your Age
Picture This - Winona Ryder
Charlotte Rose Benjamin - Party City
Tessa Kaye - Fool's Gold
Jacquie - Forever
jame - Fiya
Bankrol Hayden - Costa Rica
Masiwei - The World Is Yours
Silverstein - Infinite
Demob Happy - Mother Machine
The Lone Bellow - Good Times
Jac Ross - It's OK To Be Black
Street Bud - What's The Move
Jake Isaac - New York
Circa Waves - Move to San FranciscoEmbed In Your Eyes (feat. Alida) In Your Eyes (feat. Alida) Robin Schulz;Alida german