1 ContributorTop Hits Portugal LyricsCafeína - Dj Dadda, Plutónio
Te boté - Remix - Nio garcia, Casper Mágico, Bad Bunny, Darrell, Nicky Jam, Ozuna
Teu Eternamente - Slow J
Taki Taki - Selena Gomez, Cardi B, Ozuna
Devia Ir - Wet Bed Gang
Thank u, next - Ariana Grande
Happier - Marshmello, Bastille
MIA - Bad Bunny feat. Drake
Arms Around You- XXXTENTACION, Lil Pump, Maluma, Swae Lee
Sou Favela - MC Bruninho, Vitinho Ferrari, Batidão Stronda, DJ DG
In my mind - Dynoro, Gigi D'Agostino
Better - Khalid
O Bebê - MC Kevinho, MC Kekel
Natural - Imagine Dragons
Eastside - Halsey, Khalid
Sauce - Sippinpurpp
Mafiosa - Lartist, Caroliina
Youngblood - 5 Seconds of summer
Lucid Dreams - Juice Wrld
TIC TOC - 6ix9ine, Lil Baby
Sin Pijama - Becky G, Natti Natasha
Rise - Jonas Blue, Jack & Jack
Beautiful - Bazzi, Camila Cabello
Love Lies - Khalid, Normani
NÓS2- Bispo, Deezy
Love Someone - Lukas Graham
Taste - Tyga, Offseat
Without Me - Halsey
Vaina Loca - Ozuna, Manuel Turizo
Amor de Verdade - MC Kekel, MC Rita
Moonlight - XXXTENTACION
23 de Maio - Wet Bed Gang
Água de Coco - Profjam
Better Now - Post Malone
SAD! - XXXTENTACION
Nevermid - Dennis Lloyd
Woman Like Me - Little Mix, Nicki Minaj
Agora é Tudo Meu - Dennis DJ, MC Kevinho
Rain - mishlawi, Richie Campbell, Plutónio
Shallow - Lady Gaga, Bradley Cooper
Mesa 8 - Wet Bed Gang
Miúda - Holly Hood
Veneno - Anitta
Ocean - Martin Garrix, Khalid
Bad Liar - Imagine Dragons
Sunflower - Post Malone, Swae Lee
Sendo Assim- Sam The Kid
Happy Day - Deejay Telio, Deedz B
BAD! - XXXTENTACION
Ruin My Life - Zara Larsson1Embed MIA X 100PRE Bad Bunny;Drake latino