2 ContributorsNew Music Friday 05/03/19 LyricsShawn Mendes - If I Can't Have You
Logic - Homicide
Chelsea Cutler - please
X Lovers - Colder When It Rains
10k.Caash - Kerwin Frost Scratch That
BANKS - Gimme
Lewis Capaldi - Hold Me While You Wait
Vampire Weekend - Sympathy
Bastille - Joy
NOTD - I Miss Myself (with HRVY)
Madonna - I Rise
Joyner Lucas - Devils Work
PnB Rock - Fuck Up The City (feat. Quavo and Mally Mall)
DVBBS - GOMF (feat. BRIDGE)
Sabrina Carpenter - Exhale
YG - Go Loko
Ari Lennox - Up Late
Lil Nas X - Old Town Road - Diplo Remix
Quin Nfn - How I'm Living
Izzy Bizu - Doorstep
Still Woozy - Ipanema
FINNEAS - I Lost a Friend
Lila Drew - numb
Leven Kali - Mad At U
Bhad Bhabie - Bestie (feat. Megan Thee Stallion)
OMB Bloodbath - Scoot Must Go on
Barrie - Hutch
Sabina Ddumba - Blow My Mind
Judah & the Lion - Alright (frick it!)
Patrick Martin - Stranger Nights
Silver Sphere - lost cause
HoodRich Pablo Juan - Dance (feat. Key Glock & NLE Choppa)
Karol G - Love With A Quality
BURNS - Energy (with A$AP Rocky & Sabrina Claudio)
Old Dominion - Some People Do
The Head and the Heart - People Need A Melody
Tessa Violet - I Like (the idea of) You
Kim Petras - Got My Number
Ren - mind games
Christina Perri - tiny victories
B00TY - Money Make The Man (feat. Farrah Fawx)
JP Cooper - Sing It With Me
Ruel - Painkiller
No Rome - Pink
EMAN8 - Grateful
Blac Youngsta - Cut Up
Robin Schulz - All This Love (feat. Harlœ)
Stafford Brothers - Keep Talking
Ian Noe - Letter to Madeline
The National - Hairpin Turns
Dinosaur Pile-Up - Back Foot
Young Nudy - Extendo (feat. Lil Uzi Vert)
Col3trane - Problems In Us
Des Rocs - SLO
MorMor - Some Place Else
Lil Tjay - Ruthless (feat. Jay Critch)
Diplo - Give Dem (feat. Kah-Lo)
PNAU - Solid Gold
Of Monsters and Men - Alligator
K.Flay - This Baby Don’t Cry
Sam.Sts - Boy Who Cries
Girl Ultra - DameLove (feat. Cuco)
Iggy Azalea - Started
Maxo Kream - Still
Bad Religion - Lose Your Head
Angels & Airwaves - Rebel Girl
ROLE MODEL - minimal
Kota the Friend - Backyard
drumaq - Insecurities
Taron Egerton - Rocket Man - From "Rocketman"
Joy Williams - When Creation Was Young
Yung Gravy - Gravy Train
Raheem DeVaughn - Just Right
The Kooks - Got Your Number
Moby Rich - Sabotage
Hayden James - Nowhere to Go
Ashley Tisdale - Feeling So Good
TOBi - Come Back Home (feat. VanJess)
Ruben - Power
Renni Rucci - Fuck Em Up Sis
11:11 - Flames
Fitz and The Tantrums - I Need Help!
Frawley - Hard Boy
ASTN - Leave Me Before I Love You
GATTÜSO - Million Things
The Midnight - America Online
Mau y Ricky - La Boca
Ar'mon & Trey - Just in Case (feat. Yung Bleu)
Emeryld - Hope You’re Happy
Caamp - Penny, Heads Up
Fantasia - Enough
The Flaming Lips - All For The Life Of The City
Big Thief - Century
Jamie Cullum - Taller
New Hope Club - Love Again
Grizz - Cigar
Tink - Ride It (feat. DeJ Loaf)
FEiN - Infant
Penelope - StrangerEmbed Ruthless (feat. Jay Critch) True 2 Myself Lil Tjay;Jay Critch r-n-b