2 ContributorsPlaylist by ME! LyricsJune 2019 Update
Taylor Swift - You Need to Calm Down
Twin Shadow - Saturdays (feat. HAIM)
Ciara - Thinkin' 'Bout You
AJR - 100 Bad Days
Taylor Swift - ME! (feat. Brendon Urie)
Mumford & Sons - Woman
Shy FX - Rudeboy Lovesong (feat. Sweetie Irie & Cara Delevingne)
Khalid - Free Spirit
Lizzo - Juice
Tove Lo - Glad He's Gone
Adam Lambert - New Eyes
Katy Perry - Never Really Over
Billy Porter - Love Yourself
The National - Light Years
LANY - Pancakes
Johan - Everybody's Cool But Me
Doja Cat - Juicy
King Princess - Cheap Queen
Dermot Kennedy - Lost
Bon Iver - Hey, Ma
Carlie Hanson - Back in My Arms
Maren Morris - The Bones
Virginia To Vegas - Just Friends
Fitz and the Tantrums - Don't Ever Let 'Em
Lana Del Rey - Venice Bitch
Nina Nesbitt - Last December
Kiiara - Open My Mouth
Jessie Reyez - Great One
James Blake - Can't Believe The Way We Flow
K. Flay - This Baby Don't Cry
Lykke Li - Utopia
Julia Michaels - What a Time (feat. Niall Horan)
Sufjan Stevens - Love Yourself
Blake Rose - Lost
Oliver Tank - I Love You
Tayla Parx - I Want You
The Japanese House - Follow My Girl
Angelo de Augustine - Tomb
Bastille - Those Nights
Alex Lahey - I Want to Live with You
Illenium & Jon Bellion - Good Things Fall Apart
Dennis Lloyd - Never Go Back
Panic! At The Disco - Hey Look Ma, I Made It
Todrick Hall - Chapstick (feat. Trixie Mattel)
Ryan Hurd - To a T
Amy Shark - Mess Her Up
The Head and the Heart - Honeybee
Eryn Allen Kane - Fragile
Gallant - Doesn't Matter
Briston Maroney - Fool's Gold
Carly Rae Jepsen - Want You in My Room
The National - OblivionsSee Taylor Swift LiveGet tickets as low as $317Embed Good Things Fall Apart (with Jon Bellion) Good Things Fall Apart (with Jon Bellion) ILLENIUM;Jon Bellion edm