1 ContributorNew Music Friday 09/09/22 LyricsLewis Capaldi - Forget Me
Yeat - Flawl√´ss (feat. Lil Uzi Vert)
ROSAL√çA - CHIRI
Ari Lennox - Waste My Time
Roddy Ricch - Ghetto Superstar (feat. G Herbo & Doe Boy)
Kane Brown - Thank God
Blood Orange - Jesus Freak Lighter
NAV - One Time (with Don Toliver feat. Future)
John Legend - Wonder Woman
SPINALL - Power (Remember Who You Are)
Kygo - Woke Up in Love
Katherine Li - I Don't Care
BRELAND - For What It‚Äôs Worth
Labrinth - Kill For Your Love
Mura Masa - e-motions (with Erika de Casier)
Sudan Archives - OMG BRITT
YG - Alon–µ
WILLOW - curious/furious
Jessie Murph - While You'r–µ At It
Bryson Tiller - Outside
EST Gee - Shoot It Myself (feat. Future)
Camilo - Aeropuerto
Nessa Barrett - madhouse
5 Seconds of Summer - Older (feat. Sierra Deaton)
Sleepy Hallow - 2 Mins of Pain
YoungBoy Never Broke Again - Purge Me
Bj√∂rk - Atopos
Cavetown - 1994
Madison Cunningham - Who Are You Now
Meghan Trainor - Don't I Make It Look Easy
FLETCHER - Better Version
Phoenix - Tonight (feat. Ezra Koenig)
Big Sean - More Thoughts (2019)
Cordae - Checkmate
Hardwell - REBELS NEVER DIE
Santigold - Fall First
Coi Leray - Fly Sh!t
Imagine Dragons - Bubble - Night Visions Demo
Tom Odell - Smiling All The Way Back Home
Tyler Childers - Angel Band - Jubilee Version
G Herbo - Me, Myself & I (with A Boogie wit da Hoodie)
Sampa the Great - Let Me Be Great [Feat. Ang√©lique Kidjo] üêö
BLACKSTARKIDS - CYBERKISS 2 U*
Ozzy Osbourne - One of Those Days (feat. Eric Clapton)
Money Man - No Limit (feat. Babyface Ray)
midwxst - 223's (feat. BabyTron)
brakence - caffeine
MAX - IT'S YOU (feat. keshi)
Abe Parker - Live, Laugh, Love
NOTD - Less I Know
Forest Blakk - Another Love Song
Trevor Daniel - Story
Quevedo - Vista Al Mar
Clean Bandit - Sad Girls (feat. Rema)
Saucy Santana - I'm Too Much
Aidan Bissett - Tripping Over Air
Knox - I Don't Wanna Know
Jackson Wang - Blue
Highly Suspect - Midnight Demon Club
Nickelback - San Quentin
NGHTMRE - Nothing's Perfect
carolesdaughter - sunshine and roses
Natalie Jane - Seven
Ashley Kutcher - Sleepy
Totally Enormous Extinct Dinosaurs - Be with You
Chris Jedi - Condado
Chris Brickley - Comfortable ‚òëÔ∏è
DRAM - WHAM
Jenevieve - CaNdY LiEs
Lila Drew - Bad Juice
Alaina Castillo - party in my head (ur not invited)
Barns Courtney - Supernatural
ONE OK ROCK - Vandalize
Lil Double 0 - Good On Love (with Future)
Baka Not Nice - Body & A Face
EDEN - Reaching 2
Hyd - So Clear
Anuel AA - Nosotros
BIG30 - On My Mama
LATENIGHTJIGGY - What More
Snakehips - Who's Gonna Love You Tonight (with Tinashe)
Ari Abdul - Sinners (feat. Thomas LaRosa)
Suki Waterhouse - Nostalgia
Adam Melchor - I'm Ready
Charley Crockett - Time of the Cottonwood Trees
Avery Anna - what made you think?
Greentea Peng - Top Steppa
Sure Sure - 123
Bonobo - ATK
Big Wild - Waiting Outside
Chris Tomlin - Strongholds
Maria Becerra - AUTOM√ÅTICO
Oliver Sim - Run The Credits
Brigetta - Mad
Madison Kozak - What Does Sorry Mean
Julian Lennon - Not One Night
Amindi - CENTIPEDE (with KENNY MASON)
Ginger Root - Nisemono
Maggery - kitchen light
haer - maybe this is you ‚òëÔ∏èEmbed One of Those Days (feat. Eric Clapton) Patient Number 9 Ozzy Osbourne;Eric Clapton hard-rock