2 ContributorsNew Music Tuesday 04/14/15 LyricsRihanna - American Oxygen
Joywave - Now
Snoop Dogg - So Many Pros
Tyler, The Creator - DEATHCAMP
Zedd feat. Bahari - Addicted to a Memory
Brandon Flowers - Still Want You
Jon Bellion feat. Travis Mendes - All Time Low
Ryn Weaver - The Fool
Elle King - Catch Us If You Can
The Mowgli's - Whatever Forever
SonReal - For the Town
Yelawolf feat. Eminem - Best Friend
Will Joseph Cook - Streets of Paris
Shawn Mendes - Kid In Love
Erik Hassle - No Words
Greg Holden - Save Yourself
Best Coast - Feeling OK
Elliphant - Never Been In Love (RAC Mix)
The Japanese House - Teeth
Christine and the Queens - Saint Claude
Betablock3r - In My Head
Juicy J feat. Wiz Khalifa & R.City - For Everybody
A$AP Rocky - M'$
Young Thug feat. T.I. & Boosie Badazz - Can't Tell
The-Dream - Prime
Tei Shi - Go Slow
Steve Aoki feat. Linkin Park - Darker Than Blood
Calvin Harris feat. Ellie Goulding - Outside (Hardwell Remix)
Rebecca Clements - Pure Wasted
Avid Dancer - Stop Playing With My Heart
Halestorm - Gonna Get Mine
Art of Dying feat. Dan Donegan - Rise Up
Breaking Benjamin - Angels Fall
The Wombats - Headspace
Jack Garratt - Chemical
NoMBe - California Girls
George Fitzgerald feat. Lawrence Hart - Crystallise
Jessie Baylin - Creepers (Young Love)
Villagers - Darling Arithmetic
Sunset Sons - Blondie
Miami Horror feat. Sarah Chernoff - Real Slow
Halsey - Hurricane
The Suffers - Make Some Room
MADE IN HEIGHTS - Forgiveness
Sam Hunt - Ex to See
Civil Twilight - Holy Dove
Young Guns - Daylight
Oh Mercy - Sandy
Mt. Wolf feat. Alexa Harley - VIII
Sugarmen - Dirt
Kristian Bush - Trailer Hitch
Wilsen - Garden
Sofia Reyes - Conmigo (Rest of Your Life)
Kodaline - Human Again2Embed Outside (feat. Ellie Goulding) Motion Calvin Harris;Ellie Goulding house