4 ContributorsNew Music Friday 04/14/17 LyricsKendrick Lamar - LOVE. feat. ZACARI
Noah Cyrus - Stay Together
DNCE - Kissing Strangers feat. Nicki Minaj
Alessia Cara - The Other Side
A R I Z O N A - Electric Touch
Logic - Black SpiderMan feat. Damian Lemar Hudson
Royal Blood - Lights Out
The Score - Miracle
Machine Gun Kelly - Trap Paris feat. Quavo & Ty Dolla $ign
Linkin Park - Good Goodbye feat. Pusha T and Stormzy
Post Malone - Candy Paint
Kendrick Lamar - DNA
Lil Yachty - Peek A Boo feat. Migos
John Mayer - In the Blood
Will Joseph Cook - Treat Me Like A Lover
The Night Game - The Outfield
CAZZETTE - Handful of Gold feat. JONES
Astrid S - Breathe (Lauv Remix)
COIN - Don't Cry, 2020
LPX - Tremble
Otto Knows - With You
Kiiara - Whippin feat. Felix Snow
Bishop Briggs - The Fire
Frank Ocean - Biking feat. JAY Z & Tyler, The Creator
Kendrick Lamar - LOYALTY. feat. Rihanna
Playboi Carti - Magnolia
Kap G - Icha Gicha feat. Pharrell Williams
ZZ Ward - Ride feat. Gary Clark Jr
Sweater Beats - Altar feat. R.LUM.R
Jitta On The Track - Dr. Phil feat. Myke Green
Rag'n'Bone Man - Skin (Wilkinson Remix)
Akurei - Hinterland
Huntar - Echo
Anne-Marie- Ciao Adios (Jillionaire Remix) feat. Avelino
Katy Perry - Chained to the Rhythm feat. Lil Yachty
Little Dragon - Strobe Light
Lines - Weekends
Flint Eastwood - Rewind feat. GRiZ
RKCB - Bloom
Jimi Charles Moody - Only You
Chris Stapleton - Broken Halos
Bailey Bryan - Hard Drive Home
Johnny Balik - Made 2 Love U
Jason Derulo - Swalla (Wideboys Remix) feat. Nicki Minaj & Ty Dolla $ign
ELHAE - Something
John Gibbons - P.Y.T. (Pretty Young Thing)
Qulinez - Who You Want
Seven Lions - Freesol feat. Skyler Stonestreet
PWR BTTM - LOL
Ryan Adams - Prisoner
Grandson - Best Friends
Ho99o9 - City Rejects
Morgxn - xx
Serena Ryder - Electric Love
SNBRN & Coyote Kisses - Show Me
Cousin Stizz - Headlock feat. Offset
SAVEUS - Levitate Me
Splashh - Closer
Joseph of Mercury - Find You Inside
Tigers Jaw - June
Leo Stannard & Frances - Gravity
Blink-182 - Can't Get You More Pregnant
Black Asteroid - Howl feat. Zola Jesus
Anteros - Cherry Drop
Leo Kalyan - Versailles
Laura Marling - Wild FireEmbed Good Goodbye (feat. Pusha T and Stormzy) One More Light Linkin Park;Pusha T;Stormzy alternative