2 ContributorsNew Music Friday 08/16/19 LyricsTaylor Swift - Lover
Swae Lee - Won't Be Late (feat. Drake)
Normani - Motivation
Miley Cyrus - Slide Away
Young Thug - Bad Bad Bad (feat. Lil Baby)
ILLENIUM - In Your Arms (with X Ambassadors)
ROSALÍA - Yo x Ti, Tu x Mi
Quality Control - Pink Toes (Offset, DaBaby feat. Gunna)
Diplo - Heartless (feat. Morgan Wallen)
Jorja Smith - Be Honest (feat. Burna Boy)
FLETCHER - All Love
Kiana Ledé - Title
Lil Tecca - Ransom (with Juice WRLD) - Remix
Daya - Keeping It In The Dark - From 13 Reasons Why - Season 3 Soundtrack
YONAKA - You Need To Calm Down - Recorded At Abbey Road Studios, London
BROCKHAMPTON - BOY BYE
JPEGMAFIA - Jesus Forgive Me, I Am A Thot
Ambjaay - Ice Cream
Chelsea Cutler - How To Be Human
Macklemore - Shadow (feat. IRO) [From Songland]
Charli XCX - Cross You Out (feat. Sky Ferreira)
Highly Suspect - 16
Martin Garrix - Home (feat. Bonn)
Quality Control - Pastor (Quavo, City Girls feat. Megan Thee Stallion)
A$AP Ferg - Jet Lag
Red Hearse - Born To Bleed
phem - SWEATER
grandson - Rock Bottom
Gabrielle Aplin - Losing Me
CAL - My Brother
Old Dominion - My Heart Is a Bar
Miranda Lambert - Bluebird
The Lumineers - Left For Denver
The Highwomen - Highwomen
Calboy - Chariot (feat. Meek Mill & Lil Durk)
Arin Ray - Change (with Kehlani)
88rising - Indigo
Anna Of The North - Playing Games
Michael Kiwanuka - You Ain't The Problem
Snoop Dogg - Do It When I'm In It (feat. Jermaine Dupri, Ozuna & Slim Jxmmi)
Skrizzly Adams - Sympathy for the Drunk
Badgirl$ - Stella
MUNA - Stayaway
Hunter Hayes - My Song Too
Blake Rose - Heavy Shit
Guapdad 4000 - First Things First (feat. G-Eazy and Reo Cragun)
Valee - Uninvited
DVBBS - Need U
Slayyyter - Cha Ching
Sleater-Kinney - LOVE
Ingrid Andress - We're Not Friends
Allan Rayman - Pretty Please
Sophia Messa - What Am I Gonna Do With You
Akon - Benjamin
Cousin Stizz - Anonymous (feat. Smino)
Samm Henshaw - The World Is Mine
Big Gigantic - Friends
PVRIS - Hallucinations
Liam Gallagher - One of Us
Waterparks - Dream Boy
Calva Louise - Belicoso
Whethan - Summer Luv (feat. Crystal Fighters)
Marlhy - Bubbles
HappyBirthdayCalvin - Alone (feat. BJRNCK)
Girl Talk - No Problem
Snoh Aalegra - Toronto
Whitney - Used To Be Lonely
Big Thief - Not - Edit
Hope Tala - Anywhere
The Neighbourhood - Middle of Somewhere
Friendly Fires - Offline (with Friend Within)
PRETTYMUCH - Rock Witchu
SEBASTIAN PAUL - SO DONE
MIDLO - Emotional
Navvy - My Love
Julie Bergan - Crazy Enough
MIKA - Tiny Love
Mozzy - Bail Bond
SOB X RBE - Legend
Charlie Heat - Have A Good Time
Arlissa - Running
Channel Tres - Raw Power
P-Lo - Sneeze (feat. Kehlani)
Sabina Ddumba - Conversation (feat. Kojo Funds)
Father - A lot on ur plate
Shura - side effects
Death Cab for Cutie - To The Ground
Noah Gundersen - Lose You
Stefan Benz - Cool 4 Me
Ross Copperman - All We Have Is Now
Joseph - Good Luck, Kid
Drama Relax - All That (feat. Jeremih)
Landon Austin - Again
Maude Latour - Ride My Bike
The Murder Capital - More Is Less
Casanova - So BrooklynEmbed In Your Arms (with X Ambassadors) ASCEND ILLENIUM;X Ambassadors dubstep