1 ContributorNew Music Friday 4/30/21 LyricsBillie Eilish - Your Power
DJ Khaled - I DID IT (feat. Post Malone, Megan Thee Stallion, Lil Baby & DaBaby)
girl in red - Body And Mind
The Kid LAROI - WITHOUT YOU (with Miley Cyrus)
Machine Gun Kelly - love race (feat. Kellin Quinn)
Lil Baby - On Me (Remix) (with Megan Thee Stallion)
Baby Keem - durag activity (with Travis Scott)
Olivia Rodrigo - Even When/The Best Part - From "High School Musical: The Musical: The Series (Season 2)"
Bebe Rexha - Die For a Man (feat. Lil Uzi Vert)
Anitta - Girl From Rio
DJ Khaled - LET IT GO (feat. Justin Bieber & 21 Savage)
Joyner Lucas - Ramen & OJ
Twenty One Pilots - Chokеr
Julia Michaels - Little Did I Know
Alec Bеnjamin - The Way You Felt
WILLOW - t r a n s p a r e n t s o u l feat.Travis Barker
Jack Larsen - Saving Grace
Cake Pop - Boom
Nio Garcia - Sin Panty
NLE Choppa - Final Warning
Gucci Mane - Shit Crazy (feat. BIG30)
Still Woozy - Kenny
Joy Oladokun - sorry isn't good enough
Adam Melchor - Light Year (feat. Lennon Stella)
Daya - Montana
Thomas Rhett - More Time Fishin’
Burna Boy - Kilometre
Lil Eazzyy - Why
Morray - Can’t Use Me
21 Savage - Spiral
Shelley FKA DRAM - All Pride Aside with Summer Walker
AG Club - QUESO
ITZY - In the morning
Royal Blood - Oblivion
The Marías - Hush
Rag'n'Bone Man - Crossfire
Jessie Ware - Please - Single Edit
Louis The Child - So What (with A R I Z O N A)
Afrojack - Hero
Cali Y El Dandee - Despiértate
Lil Skies - My Baby (feat. Zhavia Ward)
Yung Baby Tate - Eenie Meenie
Tiny Meat Gang - Daddy (feat. Quinn XCII)
Max Leone - Escape
PnB Rock - Need Somebody
Justine Skye - Twisted Fantasy
Vedo - For Me
contradash - 222pm
Marc E. Bassy - Atmosphere
Charlie Houston - 19
ZHU - Yours
Diplo - One By One (feat. Elderbrook & Andhim)
Priscilla Block - Heels In Hand
Mitchell Tenpenny - To Us It Did
Jillian Rossi - Fever Dream
Bow Anderson - Hate That I Fell In Love With You
Carin Leon - More Than Words - Spotify Singles
spill tab - Anybody Else
Jordan Suaste - Hookup Culture
Snøw - Spilled My Coffee (feat. Rxseboy & Jack Cullen)
Manchester Orchestra - Telepath
Lord Huron - I Lied (with Allison Ponthier)
Crumb - Gone
Chiiild - Gone
LoveLeo - TUNG TIED
Yung Bae - Woman On The Moon (feat. UPSAHL)
SIDEPIECE - Acrobatic
bennytheghost - Papercut
The Alchemist - TV Dinners (feat. Boldy James & Sideshow)
TOBi - Family Matters (feat. Flo Milli)
Mereba - Rider
TINI - Miénteme
Hayley Kiyoko - Found My Friends
44phantom - gray!
Ai Bendr - Coffee
Madeline The Person - I Talk to the Sky
Brynn Cartelli - If I Could
Lily Rose - Overnight Sensation
Elevation Worship - Old Church Basement (feat. Dante Bowe)
Birdy - The Otherside
Niko Rubio - You Could Be The One
Britton - To My Younger Self
Terrell Hines - Who Do You Love?
Wavy Navy Pooh - Money On My Head
Tru Carr - Beat It Up
OCTAVIO the Dweeb - Someday I'll Be Happy
JayXander - Stuck in the Burbs
sunsetto - don't leave
Leo Bhanji - Damaged
kmoe - gloves
Lunay - LE GUSTA QUE LA VEAN
CLOVES - Nightmare
Amy Shark - Worst Day of My Life
Elley Duhé - Kids Of The Night
KUČKA - Your World
FRVRFRIDAY - OKAY (feat. Vory)
Kuttem Reese - No Statements (feat. Lil Durk)
Spice - Go Down Deh (feat. Shaggy and Sean Paul)
kryptogram - OlvidarEmbed I Lied (with Allison Ponthier) Long Lost Lord Huron;Allison Ponthier folk