2 ContributorsNew Music Friday 08/11/17 LyricsMarshmello - Silence feat. Khalid
Avicii - Lonely Together feat. Rita Ora
HAIM - Little of Your Love (BloodPop® Remix)
P!nk - What About Us
Avicii - Without You feat. Sandro Cavazza
Kesha - Let 'Em Talk feat. Eagles Of Death Metal
DJ Envy - Text Ur Number feat. DJ Sliink & Fetty Wap
Bebe Rexha - (Not) The One
Fifth Harmony - Angel
Stefflon Don - Hurtin' Me feat. French Montana
Bomba Estéreo - Química (Dance With Me) feat. Balkan Beat Box
Wiz Khalifa - Something New feat. Ty Dolla $ign
Bantu - Complicated feat. Shungudzo
Timeflies - Nobody Has to Know
Tritonal - Good Thing feat. Laurell
Vindata, Skrillex & NSTASIA - Favor
A$AP Ferg - Nasty (Who Dat) feat. Migos
TLC - Waterfalls (Recorded at Spotify Studios NYC)
Queens of the Stone Age - The Evil Has Landed
Buddy - That Much
Kelsea Ballerini - Unapologetically
NVDES - Dancer from New York
Jessie J - Real Deal
The National - Carin at the Liquor Store
Thomas Rhett - Sixteen
Louis Futon - Rewind feat. Ashe & Armani White
Billie Eilish - party favor
Liz Huett - STFU & Hold Me
Ella Eyre - Ego feat. Ty Dolla $ign
Gabrielle Aplin - Waking Up Slow
Grace VanderWaal - Sick of Being Told
Daughter - Burn It Down
Liam Gallagher - For What It's Worth
Tom Walker - Radioactive (Live from Spotify London)
NOTD - Summer of Love feat. Dagny
Mansionz - Wicked (Loote Remix)
WESLEE - Bathwater
R.LUM.R - Bleed Into The Water
Madeintyo - Cashing Out
Jarreau Vandal - Make You Love Me feat. Zak Abel
Emmit Fenn - Everybody Else
Klangkarussell - Good To Go
Caroline Pennell - Drive Me Home
The Horrors - Something to Remember Me By
Carlie Hanson - Why Did You Lie?
Prince Fox - Space feat. Quinn XCII
Alex Adair - Casual
Birdtalker - Looking for Love
Elliot Root - Stay
The War On Drugs - Accidentally Like a Martyr (Recorded at Spotify Studios NYC)Embed Without You (feat. Sandro Cavazza) AVĪCI (01) Avicii;Sandro Cavazza edm