1 ContributorNew Music Friday 10/01/21 LyricsMeek Mill - Intro (Hate On Me)
Kane Brown - Blessed & Free
Farruko - El Incomprendido
Burna Boy - Want It All (feat. Polo G)
Kali Uchis - fue mejor (feat. SZA)
YoungBoy Never Broke Again - Still Waiting - Bonus
Ashnikko - Panic Attacks in Paradise
Jeremy Zucker - Deep end
Gracie Abrams - Feels Like
Brandi Carlile - Broken Horses
Jessie Murph - Sobriety
aldn - predictable
Wale - Poke It Out (feat. J. Cole)
Lil Wayne - Feelin' Like Tunechi
Diplo - Promises
Elton John - Finish Line
dhruv - airplane thoughts
Rancid Eddie - Dry
Oliver Tree - The Internet
Wallows - I Don't Want to Talk
Blake Shelton - Come Back As A Country Boy
Chelsea Cutler - Devil On My Shoulder
Remi Wolf - Anthony Kiedis
Yo Gotti - For The Record
Bino Rideaux - LEMME FIND OUT
spill tab - Grade A (feat. JAWNY)
Louis The Child - Hole In My Heart (with Livingston)
Years & Years - Crave
Jake Wesley Rogers - Pluto
Danny Ocean - TÃº no me conoces
Megan Thee Stallion - Crazy Family - From "The Addams Family 2"
Skylar Grey - Last One Standing (feat. Polo G, Mozzy & Eminem)
Lonr. - CUFFIN (feat. Coi Leray)
Key Glock - Ambition For Cash
Headie One - Cry
Arizona Zervas - C U L8R
LÃ˜LÃ˜ - u look stupid
Wet - Far Cry
Wet Leg - Wet Dream
Cheat Codes - Hurricane (with Tyson Ritter)
Calum Scott - Rise
Tony Bennett - I've Got You Under My Skin
JoJo - Anxiety (Burlindaâ€™s Theme)
Ann Marie - Check For Me (feat. Chris Brown)
FaZe Kaysan - Made A Way
TWICE - The Feels
Leah Kate - F U Anthem
Valley - Cure
Forrest Nolan - MIA
Cian Ducrot - Make Believe
Mills - Five N' Dime
Lily Rose - Breakin' In
Courtney Barnett - Write A List of Things To Look Forward To
Leo Bhanji - Window Up
Mahalia - Roadside (feat. AJ Tracey)
Nija - Finesse
CHASE B - 365
Limp Bizkit - Dad Vibes
Porsh Bet$ - Neiman Marcus (Hollywood)
Aidan Bissett - Dumped
illuminati hotties - The Sway
Justin Moore - With A Woman You Love
Walker County - Liar
John Mellencamp - Wasted Days (feat. Bruce Springsteen)
The Rolling Stones - Troubles Aâ€™ Comin
Ryan Trey - Change Of Plans
RAY BLK - Baggage
Issam Alnajjar - Baree
Skip Marley - Vibe (feat. Popcaan)
Dom Kennedy - Rollin Papers
Andy Mineo - Been About It
Kent Jones - Bout That (feat. Rick Ross)
DJ Snake - Pondicherry ðŸ•’
Nicki Nicole - Parte de MÃ­
Pia Mia - Active
New Rules - Really Wanna Dance With You
Felix Jaehn - Somebody You Like
Austin Millz - Off My Mind
Nathy Peluso - LA DESPEDIDA - Live - Spotify Singles
Samm Henshaw - Chicken Wings
Sabrina Sterling - Ride Or Die
IDLES - The Beachland Ballroom
Luna Li - Flower (In Full Bloom)
Tirzah - Beating
Totally Enormous Extinct Dinosaurs - The Distance
Arca - Incendio
Zack Fox - fafo
JAHMED - TUESDAY
Derrick Milano - die4iT
Inner Wave - Fever
umru - check1
Asking Alexandria - Never Gonna Learn
Artz - Numby
Monica Martin - Go Easy, Kid
slimdan - MVP
August Royals - Oxygen
Hannah Ellis - Us
Sting - Rushing Water
CL - Lover Like Me
Leslie Grace - Bachatica1Embed Want It All (feat. Polo G) Want It All (feat. Polo G) Burna Boy;Polo G dancehall