3 ContributorsNew Music Friday 07/29/22 LyricsBeyoncé - CHURCH GIRL
ROSALÍA – DESPECHÁ
Fred again.. - Turn On The Lights again.. (feat. Future)
NAV - Never Sleep (with Travis Scott & Lil Baby)
Calvin Harris - New To You (with Normani, Tinashe, & Offset)
Rod Wave - Stone Rolling
Maggie Rogers - Anywhere With You
Tove Lo - 2 Die 4
Beyoncé - SUMMER RENAISSANCE
Quavo - Us vs. Them (feat. Gucci Mane)
Labrinth - Lift Off
Charli XCX - Hot Girl (Bodies Bodies Bodies)
Lauren Spencer-Smith – Narcissist
Glaive - i will follow you into the dark - Spotify Singles
Beyoncé - CUFF IT
Marshmello - American Psycho (with Mae Muller feat. Trippie Redd)
Gucci Mane - Dissin the Dead
$uicideboy$ - Matte Black
Hailee Steinfeld - Coast (feat. Anderson .Paak)
Benson Boone - NIGHTS LIKE THESE
King Princess - Let Us Die
Tom The Mail Man - •NOTDEAD!•
DOMi & JD BECK - PiLOT (feat. Snoop Dogg, Busta Rhymes, Anderson .Paak)
Stromae - Mon amour (with Camila Cabello)
Rauw Alejandro – LOKERA
Gryffin - Colors (with Eyelar)
Dierks Bentley – Gold
AJR - I Won't
Hayley Kiyoko - sugar at the bottom
Surfaces – Rooftops
Rina Sawayama - Hold The Girl
EKKSTACY - wish i was dead
Kyle Dion – Heatwave
EST Gee – Blood
Young Dolph - Hall of Fame
Shenseea - Rain (with Skillibeng)
Tems - No Woman No Cry
ILLENIUM - All That Really Matters
Ashe Shower With My Clothes On
Tommy Lefroy - Dog Eat Dog
Amanda Shires - Bad Behavior
Quarters of Change - Ms. Dramatic
K CAMP - If These Walls Could Talk
Hotboii - Throw In The Towel (with Lil Uzi Vert) ☑️
Wiz Khalifa - Big Daddy Wiz (feat. Girl Talk)
TSHA – Water
Bastille – Revolution
Bishop Briggs – Revolution
Ingrid Andress – Blue☑️
Plains - Problem With It
Claire Rosinkranz – 123
Joshua Bassett - Finally Free
Djo – Gloom
KillBunk - Flex On My Ex (with Bankrol Hayden)
Larry June - In My Pockets
Maxo Kream - MIXIN JUICES (feat. BabyFace Ray) ☑️
John Summit - What A Life (feat. Stevie Appleton)
AURORA - A Potion For Love
Two Door Cinema Club - Lucky – Edit
Lava La Rue – Motel
Lou Val - solitude/martini on mars
Robert Glasper - All Masks (Feat. Masego)
JAE5 - Propeller (feat. Dave & BNXN)
Chase Rice - Key West & Colorado
Maddie Zahm - If It's Not God
Lilyisthatyou - Bad Energy
Huddy - All the Things I Hate About You
Sueco - Next Ex
Tiësto - Baila Conmigo
ATEEZ – Guerrilla
DESTIN CONRAD - DAY PARTY☑️
Jackson Wang – Cruel
Noah Guy - 2 DOGS 1 LEASH
Dodie - Got Weird
Buddy - Long Day (Pussy Crazy) (feat. Gwen Bunn)
Bankroll Freddie - Patience (feat. Lil Baby)
Doe Boy - MORE THAN FRIENDS
Deaton Chris Anthony - Go!
U.S. Girls - So Typically Now
Dora Jar – Bumblebee
Zia Victoria - EVERYBODY'S GONNA DIE!
Sampa the Great – Bona☑️
Ben Reilly – Agenda
Azanti - Gettin' Hot
Dani mack - fleabag
Leah Kate - Life Sux
ZAND - Battery Acid
93FEETOFSMOKE – TOOTHPASTE☑️
Florist - Two Ways
Brooke Eden – Knock
Rat Tally – Prettier
Nate Poshkus - Lead Me On
Scott is okay - No Wonder You Never Tell Me Anything
Brandon – Cherie
Fenix Flexin - Red Flag
Lil Migo - Bad Bitch
CEO Trayle - Send My Bitch
Kwn - sweetie (feat. Scribz Riley)
Ariana and the Rose - Cosmic LoverYou might also likeEmbed New To You (with Normani, Tinashe & Offset) Funk Wav Bounces Vol. 2 Calvin Harris;Normani;Tinashe;Offset progressive-house