2 ContributorsNew Music Friday 03/15/19 LyricsSia - No New Friends
Sofia Reyes - R.I.P. (feat. Rita Ora & Anitta)
Lennon Stella - BITCH (takes one to know one)
SG Lewis - Throwaway - SG Lewis x Clairo
ScHoolboy Q - Numb Numb Juice
Tory Lanez - Freaky
Sean Paul - Contra La Pared
Nasty Cherry - Win
Chelsea Cutler - Summer Love - Recorded at Spotify Studios NYC
Anderson .Paak - King James
Rich The Kid - Tic Toc (with Tory Lanez)
The Head and the Heart - Missed Connection
Grace VanderWaal - Hideaway - from "Wonder Park"
blackbear - SWEAR TO GOD
Benjamin Ingrosso - All Night Long (All Night) - Recorded at Spotify Studios Stockholm
MISSIO - I See You
Alexander 23 - Dirty AF1s
HRVY - Told You So
Yella Beezy - Bacc At It Again
Christian French - heavy snow
Jade Bird - My Motto
Birdman - Dreams
Iggy Azalea - Sally Walker
Plastic Toy - Try Me Radio Edit - Studio
03 Greedo - Wasted (feat. YG)
Tierra Whack - Wasteland
Rayana Jay - Love Me Like (feat. DUCKWRTH)
Arcade Fire - Baby Mine - From "Dumbo"/Soundtrack Version
RuthAnne - Love Again
Jake Miller - NIKES
Hyphen Hyphen - Lonely Baby (feat. Kiiara)
Cheat Codes - Who's Got Your Love
Beast Coast - Left Hand (feat. Joey Bada$$, Flatbush Zombies, The Underachievers, Kirk Knight, Nyck Caution, CJ Fly)
Nikki Vianna - When You Leave
Lil Mosey - Bust Down Cartier
Beoga - Matthew's Daughter (feat. Devin Dawson)
Greyson Chance - yours
Karen O - Turn The Light
Elle Fanning - Dancing On My Own - From “Teen Spirit” Soundtrack
Emeli Sandé - Sparrow
Conor Matthews - Heaven Help Me
AJR - Birthday Party
Whitesnake - Trouble is Your Middle Name
Carnage - Letting People Go (feat. Prinze George)
Clara Mae - Lost
George Strait - The Weight Of The Badge
E-40 - Melt
Benjamin Francis Leftwich - Tell Me You Started to Pray
Mario - Care for You
Ray J - Hallelujah (feat. Snoop Dogg)
QUIX & Luca Lush - Berserk (feat. Yung Bambi)
Twin Shadow - Truly
Justin Love - Runaway
Obongjayar - Frens
Dawin - Flexible
Johnny Orlando - Waste My Time
GRiZ - Find My Own Way
King Gizzard & The Lizard Wizard - Fishing For Fishies
Young Bombs - Starry Eyes
Third Party - Northern Lights
Joy Williams - When Does a Heart Move On
Alec Bailey - Lemonade
Allen Stone - Naturally (Live in the Studio) - Live in the Studio
Christian Paul - When Love Don't Love You Back
Lil West - 2pennies
Cienfue - Sunset Sesh
girl in red - i need to be alone.
Retro Video Club - Addicted
Zacari - Young & Invincible
Quincy Mumford - Ain't It Sweet
Blake - Hot Sauce
Kill Miami - Dark Horses
In Her Own Words - Steady Glow
Deante' Hitchcock - Never (Let You Go)
Shura - BKLYNLDN
Stephen Malkmus - Grown Nothing
Baroness - Borderlines
FUZETA - Wandering Life
Hot Milk - Take Your Jacket
Angel Du$t - Want It All
FEVA - Undone
Easy Shapes - We Are Kings
David Leonard - Share This Burden
Rachel Wammack - Enough
Trent Dabbs - Babe, It Just Happens
Mikey Mike - Life on Earth
Triple One - Butter
Maiah Manser - See Thru It
Spencer Sutherland - Freaking OutEmbed Throwaway (with Clairo) Dawn SG Lewis;Clairo soul