11 ContributorsMay 2021 Singles Release Calendar Lyrics5/2
Tommy Ice - "Oxygen"
5/3
Joey Trap - "MORENA FREESTYLE"
Lil Darkie - "FIGHT!"
Maluma - "Vamo' a Gozárnola"
Reo Cragun - "Late to the Party" ft. Problem, Mike & Keys
Reo Cragun - "Not the Internet"
Texas - "Moonstar"
The Black Keys - "Going Down South"
YG, Mozzy & Blxst - "Perfect Timing"
YN Jay - "Coochie Language"
5/4
Cat & Calmell - "jorge"
DC the Don - "Ski (Remix)"
Don Toliver - "What You Need"
Flight Facilities - "Lights Up" ft. Channel Tres
Kevin Morby - "Dumcane"
Maisie Peters - "Funeral" ft. James Bay
Rostam - "From the Back of a Cab"
Wavves - "Help Is on the Way"
5/5
Ashe - "Me Without You"
Dizzy - "Sunflower, Are You There?" ft. Kevin Garrett
Doss - "On Your Mind"
Kelsy Karter - "Mars"
Love Renaissance (LVRN), 6LACK & WESTSIDE BOOGIE - "Just Say That" ft. OMB Bloodbath, BRS Kash
Love Renaissance (LVRN), 6LACK & WESTSIDE BOOGIE - "LVRN Cypher" ft. NoonieVsEverybody, BRS Kash, OMB Bloodbath
LUMP - "Animal"
MARINA - "Purge the Poison (Remix)" ft. Pussy Riot
Modest Mouse - "We Are Between"
OneRepublic - "Run"
TheHxliday - "Salsa"
TLE Cinco - "Next Level"
Voda Fuji - "Chill Pill"
Yung Mal - "Walkin" ft. Pooh Shiesty
5/6
A.G. Cook & Charli XCX - "Xcxoplex"
boyband - "by myself"
Cosha - "Run the Track"
CXLOE - "Cry and Drive"
Dayglow - "Balcony"
Eliza & the Delusionals - "YOU"
Eves Karydas - "Freckles"
Haley Mae Campbell - "Never Been in Love"
Hayley Mary - "Young & Stupid"
Jack Savoretti & Nile Rodgers - "Who's Hurting Who"
Jake Hill - "state of mind"
joan - "so good"
Lil Tecca - "Never Left"
Little Simz - "Woman" ft. Cleo Sol
Matilda Mann - "My Point of You"
NEEDTOBREATHE - "Into the Mystery"
Ozuna - "Tiempo"
RAY BLK - "Dark Skinned"
Rise Against - "The Numbers"
Sydney Mack - "Dark Horse"
Tai Verdes - "A-O-K"
YONAKA - "Call Me a Saint"
5/7
1UP & 916frosty - "Eastern Wind"
A1 x J1 - "Latest Trends (A Boogie Remix)" ft. A Boogie wit da Hoodie
Adelén - "Safety Light"
Alok, Sofi Tukker & INNA - "It Don't Matter"
AYO SK3TCH - "Livin' My Life" ft. Lil Gotit
Azizi Gibson - "THEM!?"
Babyface Ray - "A Million Cash Race"
Bebe Rexha - "Break My Heart Myself"
Blxst - "Forever Humble"
Boombox Cartel - "Reaper" ft. JID
Boys Noize - "All I Want" ft. Jake Shears
Cassadee Pope - "What the Stars See" ft. Lindsay Ell & Karen Fairchild
Chief Keef, Tadoe & Ballout - "On Gang"
Clean Bandit - "Higher (Dimitri Vegas & Like Mike Remix)" ft. iann dior
Coi Leray - "Bout Me"
Coldplay - "Higher Power"
Conan Gray - "Astronomy"
CUCO - "Forevermore"
Dan Bull & The Stupendium - "Tune Into the Madness"
David Guetta - "Get Together"
DC the Don - "Daij is Drunk"
deadman 死​人 - "Anime Song (Omae Wa Mou Remix)"
Don Diablo - "Through the Storm" ft. Jordan Mackampa
ELIO, Chase Atlantic & No Rome - "hurts 2 hate somebody (Remix)"
Emilie Adams - "Monogamy"
Felix Cartal & Karen Harding - "Only One"
Flipp Dinero - "The Get Back"
Fredo Bang - "Oppanese"
Georgia Twinn - "Moth"
Godfather of Harlem - "Shit Don't Feel Right" ft. Buddy
Gracie Abrams - "Mess It Up"
ILLENIUM, Valerie Broussard & Nurko - "Sideways"
Imanbek & Cher Lloyd - "Baddest"
Inhaler - "Who's Your Money On? (Plastic House)"
Isaiah Rashad - "Lay Wit Ya" ft. Duke Deuce
J. Cole - "​i n t e r l u d e"
Jake Bugg - "Lost"
Jennifer Nettles - "Wait for It"
Joshua Bassett - "Feel Something"
Joywave - "Every Window is a Mirror"
JP Saxe - "Like That"
Jutes - "Painkiller"
Kash Doll - "Thumbin"
KAWALA - "1,000,000x Better"
KennyHoopla - "hollywood sucks//" ft. Travis Barker
KILLY - "PYRO (Remix)" ft. scarlxrd
Kodak Black - "Rip Stick" ft. Pooh Shiesty & Syko Bob
KyleYouMadeThat & Justis Bratt - "Haha (Please Be Kind)"
Like Saturn - "melancholy abyss"
Lil Candy Paint - "ATM"
Masked Wolf - "Astronaut in the Ocean (Remix)" ft. G-Eazy & DDG
MOL$ & Desired - "TOO COLD (Future Funk Mix)"
Nick Wilson - "Say Something"
Njomza - "​winter in atlanta" ft. Russ
Omarion - "We Will Never Forget" ft. Kierra Sheard & Lalah Hathaway
P!nk - "All I Know So Far"
Powfu, Sarcastic Sounds & Sara Kays - "the long way home"
Quin NFN & Derez De'Shon - "Having My Way"
Rah Swish - "WOO IT AGAIN"
Reem - "Trips"
REI AMI - "F.R.A."
Ryan Griffin - "Mama's Boy"
Russ - "SMALL TALK"
Saweetie - "Fast (Motion)"
Scorey - "Rock 'n' Roll"
Slayyyter - "Over This!"
SORAN - "Say It to My Face"
SpotEmGottem - "Federal"
Sylvie Kreusch - "All of Me"
SypSki - "Break My Bank (Remix)"
Tate Kobang & Working on Dying - "Stop the World"
Tay Money - "PBJ"
TeaMarrr - "Specific" ft. DUCKWRTH
Tech N9ne & Hu$h - "Let Lost Happen"
Tom Odell - "​money"
Trippie Redd & Playboi Carti - "Miss the Rage"
UnoTheActivist - "Lights Off" ft. Drakeo the Ruler
Walker Hayes - "Country Stuff" ft. Jake Owen
XANAKIN SKYWOK - "Limo Boys"
Young M.A - "Hello Baby" ft. Fivio Foreign
Yungeen Ace - "Back Like I Neva Left"
5/8
BEXEY - "Whiplash Moodswings"
IRIS - "BioBond"
Tommy Ice - "Other Side"
5/9
Brokeasf - "Drop"
Surf - "STOP ASKING ME"
5/10
Cautious Clay - "Wildfire"
Priya Ragu - "Forgot About"
Skrillex, Four Tet & Starrah - "Butterflies"
St. Vincent - "Down"
5/11
30 Deep Grimeyy - "First Day Out the Feds"
Elton John & Years & Years - "It's a Sin"
Emlyn - "B.O.M.B."
Foolio - "Handle Business"
Hanson - "Annalie"
Oscar Lang - "Are You Happy?"
Sleater-Kinney - "Worry with You"
SoGone SoFlexy - "Big Wide Body"
Sugababes - "Run for Cover (MNEK Remix)"
Wolf Alice - "No Hard Feelings"
Young Nudy - "2Face" ft. G Herbo
5/12
AJ Mitchell - "GROWING PAINS"
Brodka - "Hey Man"
Charli Adams - "Headspace" ft. Ruston Kelly
Demi Lovato - "Met Him Last Night (Dave Audé Remix)" ft. Ariana Grande
DUCKWRTH & Rayana Jay - "Birthday Suit"
easy life - "have a great day"
EGOVERT & 1nonly - "Sexyback!"
Elaine - "Right Now"
Erika de Casier - "Busy"
Gaspard Augé - "Hey!" ft. Justice
Laura Mvula - "Got Me"
LAUREL - "Let Go"
Liz Phair - "In There"
Margo Price - "Long Live the King"
Mike Williams & Felix Jaehn - "Without You"
Miles Wesley - "Golden"
Pi'erre Bourne - "Groceries"
renforshort & glaive - "fall apart"
Steven Wilson - "ANYONE BUT ME"
TORRES - "Don't Go Putting Wishes in My Head"
Waterparks - "Just Kidding"
Weezer - "All My Favorite Songs (Remix)" ft. AJR
Winnetka Bowling League & Sasha Sloan - "barcelona"
5/13
Allison Ponthier - "Harshest Critic"
Brahman - "​this place is not for people any more"
Bugzy Malone - "Skeletons"
Erasure - "Secrets"
Internet Money - "His & Hers" ft. Don Toliver, Lil Uzi Vert & Gunna
JAY1 - "Blazed"
Jorja Smith - "Bussdown" ft. Shaybo
K-Trap - "Warm"
Lia Pappas-Kemps - "Sad in Toronto"
Liza - "LANSDOWNE"
Rozzi - "I Can't Go to the Party"
Skrillex, Swae Lee & Siiickbrain - "Too Bizarre"
Spinabenz - "I DON'T SMOKE KENDRE"
VTP Rossa - "Stupid"
wifisfuneral - "Where I'm Going"
YoungBoy Never Broke Again - "White Teeth"
5/14
2KBABY - "Great White"
A.CHAL - "High Horse"
Alan Walker & Conor Maynard - "Believers"
Alicia Keys - "Underdog (Remix)" ft. Nicky Jam & Rauw Alejandro
Annika Wells - "The Bitter End"
Au/Ra - "Bite Marks"
B.I, Destiny Rogers, & Tyla Yaweh - "Got It Like That"
Bella Poarch - "Build a Bitch"
Black Birdie - "JUGGLIN'"
Brennan Savage - "This is Not a Love Song"
Bryce Vine - "Blame It on Me"
Bryce Vine - "The Game" ft. Thutmose
Calboy - "Ten Toes Down"
Casey Bishop - "Love Me, Leave Me"
Cavetown - "Ur Gonna Wish U Believed Me"
Chayce Beckham - "23"
Chief $upreme - "Run It Up" ft. Young Thug
Claire Rosinkranz - "Frankenstein"
Dee Watkins - "Gucci Bucket Hat"
Dixie - "FUCKBOY"
Dorian Electra - "Ram It Down (Remix)" ft. Mood Killer, Lil Mariko & Lil Texas
DUSTY LOCANE - "ROLLIN N CONTROLLIN, Pt. 2 (PICTURE ME)"
Dustin Lynch - "Tequila on a Boat" ft. Chris Lane
ELENA ROSE - "Pimienta"
Enchanting - "Freaky Deaky" ft. Coi Leray
FCG Heem - "Beef" ft. Pooh Shiesty
gavn! - "Destroy Me"
Ghastly - "Blackout"
Godfather of Harlem - "No Favors"
Gorgon City & Hayley May - "Never Let Me Down"
Grace Kinstler - "Love Someone"
Greentea Peng - "Dingaling"
Horsey - "Seahorse" ft. King Krule
Ian Flanigan - "Grow Up"
Jhonni Blaze & Popp Hunna - "Backend (Remix)"
Josh Golden - "I Love You But"
Joy Oladokun & Maren Morris - "Bigger Man"
Jubël - "Dumb"
Jutes - "Mirror Mirror"
Katy Perry - "Electric"
KEiiNO - "Summer of My Life"
Larry June - "Wait On Me"
Leon Bridges - "Motorbike"
LightSkinKeisha - "Drama"
Like Saturn - "after hours"
Lil Gnar, Ski Mask the Slump God & Chief Keef - "NEW BUGATTI" ft. DJ Scheme
Loud Luxury & Thutmose - "Red Handed"
Lukas Graham - "Happy for You"
Lxandra - "Sideways"
Mak Sauce - "Razor Blade Flow (Remix)" ft. ZaeHD & CEO & YungManny
Malou Prytz - "Echo"
Manic Street Preachers - "Orwellian"
Martin Garrix - "We Are the People" ft. Bono & The Edge
Meduza - "Headrush" ft. Elroii
Migos - "Straightenin"
Nevaeh Jolie - "Sorry, I’m High"
Noah Kahan - "Part of Me"
Offset Jim & Bravo the Bagchaser - "Specialist"
Olivia Rodrigo - "good 4 u"
Poutyface - "BORED!" ft. phem
Quinn Lewis - "Castle Walls"
RetcH, V Don & Maxo Kream - "Shiesty"
Russ - "STATUS"
Rowdy Rebel & A Boogie wit da Hoodie - "9 Bridge"
S+C+A+R+R - "What People Say"
Sage the Gemini - "Cereal Milk"
Saint Motel - "It's All Happening"
Sam Fischer - "Simple"
Sarcastic Sounds - "say goodbye"
scarlxrd - "WAKE UP!"
SHY Martin - "Feelings"
Smoke DZA - "Big Steppa" ft. Curren$y & Westside Gunn
Smoove'L - "Billie Green"
Snugs - "Roommates" ft. Tony Ferrari
Surfaces - "Next Thing (Loverboy)"
T-Pain & Kehlani - "I Like Dat"
The Three Braincells - "Astronaut In The Ocean Remix (Astronaut In The Cum Bath)"
The Rasmus - "Bones"
The Vaccines - "Headphones Baby"
Tones and I - "Won't Sleep"
Tyler Shaw - "Be Like You"
UPSAHL - "Douchebag"
VRSTY - "MONTERO (Call Me by Your Name)"
Willie Spence - "Never Be Alone"
YSN Fab - "Win Sum Mo"
Zachary Knowles - "tendency to be a loner"
Zhavia Ward - "Big Girl$ Don't Cry"
5/15
KanKan - "X n Oxy"
Token - "Hi J. Cole..."
5/16
MKULTRA - "Watching Me" ft. CHRIST DILLINGER & Lil Darkie

5/17
Billie Marten - "Human Replacement"
Byron Juane - "When It's Real"
Green Day - "Pollyanna"
Hopsin - "Be11a Ciao"
John Grant - "Billy"
Pasto Flocco - "Kid Cudi Remix"
Rich Homie Quan - "To Be Worried"
Sada Baby - "Little While" ft. Big Sean & Hit-Boy
TyFontaine - "Addicted"
5/18
Amorphous & Kehlani - "Back Together"
Bleachers - "Stop Making This Hurt"
Cold Hart - "Decompose"
Faye Webster - "I Know I'm Funny haha"
James Vincent McMorrow - "Paradise"
Mooski, Chris Brown & A Boogie wit da Hoodie - "Track Star" ft. Yung Bleu
osquinn - "coping mechanism"
Simply Red - "Earth in a Lonely Space"
Smino & Monte Booker - "Rice & Gravy"
twenty one pilots - "Saturday"
5/19
Anderson East - "Drugs"
Cher - "Walls"
Danny Wolf & Lil Baby - "Slidin"
Duran Duran - "Invisible"
Garbage - "Wolves"
Holly Humberstone - "The Walls Are Way Too Thin"
Huddy - "For Real" ft. Surf
Japanese Breakfast - "Savage Good Boy"
Kate Nash - "Misery"
koi - "make it up"
Lucy Dacus - "VBS"
MARINA - "Ancient Dreams in a Modern Land"
Oneohtrix Point Never & ROSALÍA - "Nothing's Special (Remix)"
Pond - "America's Cup"
Pero - "Mathima Zois"
salem ilese - "Dinosaurs (S4E7)"
Vance Joy - "Missing Piece"
Waterparks - "Violet!"
5/20
88rising & Warren Hue - "Too Many Tears"
Alanis Morissette - "Rest"
Charlotte Day Wilson - "If I Could"
Fousheé - "​enjoy the silence"
Galantis, David Guetta & Little Mix - "Heartbreak Anthem"
Glass Animals & Bree Runway - "Space Ghost Coast to Coast (Remix)"
Gretta Ray - "Human"
Hauskey - "Cream Shirt"
Jade Bird - "Different Kinds of Light"
JVKE - "Secrets"
Lana Del Rey - "Blue Banisters"
Lana Del Rey - "Text Book"
Lana Del Rey - "Wildflower Wildfire"
Litany - "Cream"
Lola Young - "Bad Tattoo"
Maja Francis - "PMS Party"
Matt Simons - "Self Control"
MAY-A - "Swing of Things"
Ruth B. - "Die Fast"
Savage Ga$p - "rose petal princess" ft. Wassup Rocker
Sharon Van Etten & Angel Olsen - "Like I Used To"
Tai Verdes - "i deserve 2 b alone"
Tirzah - "Sink In"
5/21
Abby Holliday - "8 Hours"
A Boogie wit da Hoodie - "24 Hours" ft. Lil Durk
Agnes - "24 Hours"
Alvaro Soler - "Si Te Vas"
Anitta - "Girl from Rio (Remix)" ft. DaBaby
Anne-Marie & Niall Horan - "Our Song"
Ashten Ray - "Convenient" ft. Tech N9ne
Audri Nix - "No Siento Na"
Azizi Gibson - "Last Minute Trips"
Baby Rich - "Simon Says"
Banoffee - "Tapioca Cheeks"
Becky G - "You Belong"
Benjamin Ingrosso - "Smile"
benny maybe & Miles Wesley - "Droptop Impala"
Betta Lemme - "Ce Soir"
Birdman & Roddy Ricch - "STUNNAMAN" ft. Lil Wayne
BKTHERULA - "Blue"
BKTHERULA - "Santanny"
Bobby Sessions - "Gold Rolex" ft. Benny The Butcher & Freddie Gibbs
BONES & GREAF - "Cellophane"
Boys World - "All Me"
Brandy - "Starting Now"
Bruh Bruh - "Quarantine in Houston" ft. Lil Durk
BTS - "Butter"
Cam Wallace & Wiz Khalifa - "Retail (Remix)"
Carlie Hanson - "Gucci Knife" ft. MASN
City Girls - "Twerkulator"
convolk - "do 2 much"
CRYWLFCRY - "Pursuit of Happiness"
Dan Bull - "Just Die Already"
Dappy - "Bolo" ft. Abra Cadabra
Darren Criss - "​i can't dance"
Declan J Donovan - "Into the Fire"
Delacey - "Drama Queen"
Dream - "Mask"
Eagle-Eye Cherry - "I Like It"
Edot Babyy - "Illegal"
Eloise - "Who's She"
Fallulah - "Gemstoned"
Felix Cartal & Hanne Mjøen - "My Last Song"
Georgia & David Jackson - "Get Me Higher"
Godfather of Harlem - "We Want Justice Dammit!" ft. Shoota93, Freddie Gibbs & Swizz Beatz
ILLENIUM, Valerie Broussard & Nurko - "Sideways (Quintino Remix)"
Intensify & Lil He77 - "Tony Montana" ft. EGOVERT
Jaah SLT & Erica Banks - "In My Bag (Remix)"
JoeVille - "It's Whatever" ft. KenTheMan
Joey Cool - "Way Down" ft. Mackenzie Nicole
JON VINYL - "Told You"
Josie Man - "One of Those Days"
JP Cooper - "Holy Water"
Jutes - "Extra Extra"
K.Flay - "TGIF" ft. Tom Morello
K Suave - "Sexually Active" ft. Trippie Redd
Kelli-Leigh - "Feelin' U"
KEY! & K$ace - "DUI"
Kidd Kenn - "Moves" ft. Rico Nasty
KILLY - "RICK BOOTS"
Kungs - "Never Going Home"
Lemaitre - "Trip Sitter" ft. Sofiloud
Like Saturn - "thin atmosphere"
Lil Baby & Kirk Franklin - "We Win"
Lil Nas X - "SUN GOES DOWN"
Latto - "The Biggest"
Lily Rose - "Remind Me of You"
LOONY - "Either Side"
Madison Ryann Ward - "Emotions"
Marshmello & Jonas Brothers - "Leave Before You Love Me"
Max B - "75 In The Can"
Mike Posner - "Jealousy" ft. blackbear
MK - "Chemical"
Money Man & Young Dolph - "Whole Lotta"
NateWantsToBattle - "Show Yourself"
Nea - "Sucker for You"
NEEDTOBREATHE - "I Wanna Remember" ft. Carrie Underwood
NextYoungin - "BlahBlahBlah"
Polo G & Lil Wayne - "GANG GANG"
POORSTACY - "Public Enemy"
Rebecca Black - "Worth It for the Feeling"
REZZ - "Taste of You" ft. Dove Cameron
RMR - "Vibes" ft. Tyla Yaweh
Royal & the Serpent - "phuck u"
Russ - "3:15 (Breathe)"
Sa Vich & Mac Ro - ''Please Stay (Remix)'' ft. David Kaho
scarlxrd - "EARACHE."
Sean Kingston - "Darkest Times" ft. G Herbo
Seezyn - "Fortune"
Shungudzo - "I'm not a mother, but I have children"
Souly Had - "DRUGS"
Squash - "Rate Who Rate You"
Steve Aoki & Yves V - "Complicated" ft. Ryan Caraveo
Sueco - "SOS (Acoustic)"
$UICIDEBOY$ - "Avalon"
Sycco - "Time's Up"
T.I. - "What It's Come To"
Tech N9ne - "Kickiter" ft. Shao Dow
Tenille Arts - "Back Then, Right Now"
The Veronicas - "Sugar Daddy"
Token - "Chit Chat"
TroyBoi - "Inspirado En Mexico"
Twin Shadow - "Get Closer"
Wafia - "Pick Me (Remix)" ft. Rahmania Astrini
Woodie Smalls - "No Limit" ft. AKTHESAVIOR
Years & Years & Kylie Minogue - "Starstruck (Remix)"
YUNDER - "DIGITAL TRASH" ft. Yun Head & Wonder
Zeina - "Teach"
Zella Day - "Dance for Love"
5/22
Fetty Wap - "Homies"
5/23
LilyPichu - "POM POM"
Phaydo - "FADE TO BLACK" ft. Surf
TyFontaine - "Spill My Cup" ft. Autumn!

5/24
easy life - "ocean view"
FunnyMike - "Cool Trollz"
Keith Ape - "Yuh Dig"
Lil Gotit - "Work Out" ft. Gunna
Lil Peppa & Buzzboi - "EWWWWWW"
Modest Mouse - "Leave a Light On"
Russ Millions & Tion Wayne - "Body (Remix)" ft. Jack Harlow
Tamera - "Wickedest"
5/25
AFI - "Tied to a Tree"
Bun B & Cory Mo - "This World" ft. Big K.R.I.T., Raheem DeVaughn & Trae tha Truth
Cam Anthony & Blake Shelton - "She Drives Me Crazy"
DMX - "Hood Blues" ft. Westside Gunn, Benny the Butcher & Conway the Machine
EARTHGANG - "Aretha"
Fredo Bang - "Slow Roll It"
Jordan Matthew Young & Blake Shelton - "All My Ex’s Live In Texas"
Kenzie Wheeler & Kelly Clarkson - "When You Say Nothing At All"
Maple Glider - "Baby Tiger"
Melissa Etheridge - "One Way Out"
Olivia Holt - "Today"
Rachel Mac & Nick Jonas - "Best of You"
Victor Solomon & John Legend - "Someday We'll All Be Free"
Vistas - "Dayglow"
Wye Oak - "TNT"
5/26
Anna Sofia - "Eat It All Up"
Audrey Mika - "Alive"
Call Me Karizma - "Way I Am"
Chelsea Wolfe - "Diana"
Chris Webby - "Young Boy" ft. RiFF RAFF & SB the Wavegod
D Double E - "Near You" ft. Chronik & Triggz
Derivakat - "Win It All"
Ethan Ross - "BEEN THRU" ft. 916frosty
FN DaDealer - "Bloodshed"
Fenix Flexin - "For Me"
half•alive - "TIME 2"
Half Waif - "Sodium and Cigarettes"
Hayley Mary - "The Drip"
JAWNY - "Take It Back"
Jazz Cartier & Buddy - "Two of 'Em"
L Devine - "Girls Like Sex"
Ladyhawke - "Mixed Emotions"
Mudhoney - "Ounce of Deception"
Mustafa - "The Hearse"
Nascar Aloe - "Judge Me However You See Fit"
Picture This - "If Ever However Whenever Forever"
Poppy - "Fear of Dying"
Ralph - "Love Potion"
Sarah Barrios - "I H8 EVERY1"
Sigrid - "Mirror"
Sleater-Kinney - "High in the Grass"
Sleepy Hallow - "Chicken"
Sleepy Hallow - "Mi No Sabe"
Slimelife Shawty - "Baby Boy"
The Academic - "Kids (Don't End Up Like Me)"
The Wombats - "Method to the Madness"
Tone Stith - "Like the First Time"
WESTSIDE BOOGIE - "Coochie (Freestyle)"
wifisfuneral & jetsonmade - "CC Demon"
Wiz Khalifa - "SKI Weedmix"
5/27
88rising, Rich Brian & NIKI - "California" ft. Warren Hue
Alice Longyu Gao & Alice Glass - "LEGEND"
Asiahn - "OMW"
Aya Nakamura - "Bobo"
Audio Chateau - "Warriors Freestyle" ft. 24kGoldn
Ebhoni - "Rep It"
Fryars - "Moscow" ft. Rae Morris
Girl Ray - "Give Me Your Love"
Griff - "One Foot in Front of the Other"
JoJo - "Creature of Habit"
Joyner Lucas - "Back In Blood (Remix)"
Kelvyn Colt - "Rapunzel"
MØ - "Live to Survive"
Morrisson - "House & Garage" ft. Aitch
Ms Banks - "Pull Up" ft. K-Trap
NSG - "Colonization"
PnB Rock - "Forever Never" ft. Pink Sweat$ & Swae Lee
Seon & 7ru7h - "Memory Lane"
Stay Flee Get Lizzy - "Meant to Be" ft. Central Cee & Fredo
Snupe Bandz, Key Glock & Jay Fizzle - "Go Hard"
Stay Flee Get Lizzy - "Meant To Be" ft. Central Cee & Fredo
Tommy Genesis - "peppermint"
Will Young - "Elizabeth Taylor"
Xavier Weeks - "Hello"
Yola - "Stand For Myself"
Yorke - "Window Shopping"
Yung Kayo & Young Stoner Life - "bstroy socks"
Ye Ali - "No Attachments"
5/28
30 Deep Grimeyy & NWM Cee Murdaa - "Make It Clap"
916frosty & Vita Flare - "riverbank"
93FEETOFSMOKE - "BLOODYMARY (sheeeesh!)"
Abhi the Nomad & Kota the Friend - "Rockstar"
Abhi the Nomad - "Good Luck"
almost monday - "this is growing up"
Alok & BLOODLINE - "Another You" ft. The Vamps
Armin van Buuren - "Battlefield"
AWA - "24/7"
BeachBoyTae, Big Flock & Bandhunta Izzy - "Back to Back"
Bebe Rexha - "Sacrifice (Nathan Dawe Remix)"
Big Freedia - "Judas"
BigKayBeezy - "Killumbus"
Billy Marchiafava & ANH - "Mardi Gras" ft. Shotgun Willy
Blueface & Calboy - "Patience"
Blxst & Bino Rideaux - "Movie"
Bob Sinclar - "We Could Be Dancing" ft. Molly Hammar
Boobie Lootaveli - "FUCK THE SUB UP"
Brother Leo - "People"
BVDLVD - "LIFE WITHOUT LOVE"
Cochise & $NOT - "Tell Em"
Culture Jam, YoungBoy Never Broke Again & Rod Wave - "Everything Different"
CJ Fly - "My Kid"
CAMERON AZI & $ubjectz - "Hello"
Darin - "Can't Stay Away"
David Shawty - "eieio"
Delilah Montagu - "Coming For Ya"
Destiny Rogers - "West Like" ft. Kalan.FrFr.
DOPE LEMON - "Rose Pink Cadillac"
Dynoro - "Monsters" ft. 24kGoldn
Domani - "Burnout" ft. Shad da God
EARTHGANG, Wale & Coi Leray - "Options (Remix)"
Edot Babyy - "Finish the War" ft. Sha EK
Eminem, Jack Harlow & Cordae - "Killer (Remix)"
ericdoa - "fantasize"
Exit & SypSki - "Down & Out (And Punked)" ft. raspy & Landon Cube
Fat Nick - "Risk Taker"
Fatboibari - "Mud"
G Flip - "Not Even In Vegas" ft. Thomas Headon
George Cosby - "Day In Day Out"
GIRLI - "More Than a Friend"
Grace Davies - "testosterone"
Groundbreaking - "Fearless"
Hey Violet - "Dear Love"
Hotboii & Future - "Nobody Special"
IDK & Offset - "SHOOT MY SHOT (New Impressionz Go-Go Edit)"
IDLES - "Damaged Goods"
ionnalee - "summer never ended the damage was all mine"
Isaac Zale & Smokepurpp - "Gasoline"
Jacob Whitesides - "therapy" ft. blckfriend
Jay5 - "Down Bad" ft. Vory
Jelly & Pi'erre Bourne - "In and Out"
Jonas Blue & LÉON - "Hear Me Say"
Josh A - "DOUBT ME"
Jufu - "KIWMB"
Just Juice - "Swallowa" ft. Lil Tjay
Jutes - "Day Dreaming"
Kat Cunning - "Boys"
KB Mike - "Toxic Love" ft. Luh Kel
Kings of Convenience - "Fever"
​kostromin - "Моя голова винтом (My head is spinning like a screw) [Remix]" ft. Fivio Foreign
Krizz Kaliko - "Weight"
Larry June - "You Gotta"
Lawson - "Blind"
LBS Kee'vin - "Spaghetti"
LBS Kee'vin - "Supplier Flow"
LEISURE - "Take You Higher"
Leony - "No More Second Chances"
Like Saturn - "fog season"
Lil Spooki - "Day Off" ft. Quin NFN
Lil Toe - "Ukraine Freestyle"
Little Mix - "Confetti (Acoustic)"
Lost Kings - "I Miss the Future" ft. Jordan Shaw
Lucus & YSB Tril - "MANSION"
Marc E. Bassy - "Trouble"
Marshmello & Carnage - "Back in Time"
Master KG & David Guetta - "Shine Your Light" ft. Akon
MCM Raymond & Remble - "The Rip"
Nessa Barrett - "I’m Dead" ft. jxdn
NGHTMRE & Alexandar Smash - "Speak Easy" ft. Ghostlo
Njomza - "over and done"
Now United - "Nobody Like Us"
Ohgeesy - "Get Fly" ft. DaBaby
Ollie - "Distance"
PNAU & Budjerah - "Stranger Love"
Preme - "Lost Hope"
Regard, Troye Sivan & Tate McRae - "You (Topic Remix)"
Russ - "Private" ft. Rexx Life Raj
Ryan Caraveo - "No Fun"
Sam Feldt & Sam Fischer - "Pick Me Up"
scarlxrd - "REAL TALK."
Smoove'L - "GRIME"
Sofi Tukker & Amadou & Mariam - "Mon Cheri"
Sophie and the Giants - "Don't Ask Me to Change"
Steven Moses - "Confessions of a Hotboy"
Skizzy Mars - "Detached"
Skooly - "Low Key"
Symphani Soto & Eric Bellinger - "Just a Moment"
Tate McRae - "Darkest Hour"
The Maine - "Lips"
Tiana Major9 - "Silly Games"
Timmy Trumpet - "Camelot" ft. Smash Mouth
Tom Odell - "lose you again"
Toosii - "Lemon Pepper Freestyle"
Travis Thompson - "Crossfaded"
Twelve'len - "Broken Wings"
Tyroné Laurent - "ENOUGH 2" ft. Autumn!
Vaishalini - "In Between Girl (Summer Mix)"
Victoria Justice - "Too Fuckin' Nice"
wewantwraiths - "Lifestyle"
Wrabel - "nothing but the love"
Xan Griffin - "Save Me"
YSN Flow - "Pac-Man"
Yung Pinch & PLVTINUM - "Dead 2 Me"
Yung Van & guardin - "Something’s in the Way"
5/31
Boosie Badazz - "Clutchin" ft. Dee Rogers
​cupcakKe - "Moonwalk"
Derivakat - "Stand Out Fit In"
Doe Boy & Rowdy Rebel - "Shmurda Talk"
Isaiah Rashad - "200/Warning"
Lil Baby & Lil Durk - "Voice of the Heroes"
Lil Quill - "Freestyle"
Lute - "Myself" ft. Devn
Meek Mill - "Flamerz Flow"
OMB Peezy - "Coming From Me"
osquinn - "53021"
Rod Wave - "Forever Set In Stone"
Ugly God - "In The Kitchen"
Xanman - "Uh Huh"2Embed I Can't Sleep Some Boring, Love Stories Powfu;Sarcastic Sounds sad