3 ContributorsNew Music Friday 11/15/19 LyricsBillie Eilish - everything i wanted
Khalid - Up All Night
Marshmello - Tongue Tied (with YUNGBLUD & blackbear)
Taylor Swift - Lover (Remix) [feat. Shawn Mendes]
Taylor Swift - Beautiful Ghosts - From The Motion Picture "Cats"
REI AMI - DICTATOR
A Boogie Wit da Hoodie - Reply (feat. Lil Uzi Vert)
Tory Lanez - Beauty In The Benz (feat. Snoop Dogg)
Camila Cabello - Living Proof
Lauv - Mean It
Future - Last Name (feat. Lil Durk)
FLETCHER - One Too Many
J Balvin - Blanco
R3HAB - Flames (with ZAYN & Jungleboi)
Céline Dion - Lovers Never Die
BENEE - Supalonely
Trippie Redd - Death (feat. DaBaby)
Vince Staples - Yo Love - From "Queen & Slim: The Soundtrack"
Kacey Musgraves - All Is Found - Kacey Musgraves Version
Chiiild - Darling
Grimes - So Heavy I Fell Through the Earth - Algorithm Mix
Jhené Aiko - None Of Your Concern
Lil Peep - Fangirl
BabyJake - BLUE CELLOPHANE
Jessie Reyez - Crazy
Tayla Parx - Fight (feat. Florida Georgia Line)
Fall Out Boy - Bob Dylan
Moby Rich - Happy Pill
Charlotte Lawrence - God Must Be Doing Cocaine
NLE Choppa - Dekario
NGHTMRE - CASH COW (with Gunna)
Ricky Martin - Cántalo
Jordan McGraw - We Should Still Be Friends
Anna Sofia - No Fun
JUMEX - DRUGS
MUNA - Motivation - Recorded at Electric Lady Studios NYC
Olivia O'Brien - Sad Songs In The Summer
Glass Animals - Tokyo Drifting (with Denzel Curry)
Fabolous - B.O.M.B.S.
Naughty Boy - Live Before I Die
Dillon Francis - Barely Breathing
Justin Jesso - Bigger Than
Hayley Kiyoko - L.O.V.E. Me
Jake Bugg - Kiss Like the Sun
Lady Antebellum - Be Patient With My Love
Train - Mai Tais (feat. Skylar Grey)
Oh Wonder - I Wish I Never Met You
Justin Caruso - Broken Hearts
Luh Kel - Tweakin
Flipp Dinero - How I Move (feat. Lil Baby)
Moses Sumney - Virile
Absofacto - Rewind
ROLE MODEL - that's just how it goes
Beck - Everlasting Nothing
Modest Mouse - Ice Cream Party
X Lovers - Never Fucking Fall in Love Again
Deborah's Child - Tsuname
Ryan Beatty - Patchwork
DJ Shadow - Kings & Queens (feat. Run The Jewels)
Pardison Fontaine - Take It Down (feat. Offset)
Kaash Paige - 64'
Greeicy - Aguardiente
True Damage - GIANTS
Madeon - No Fear No More
Griff - Sound of Your Voice
COIN - Let It All Out (10:05)
Caitlyn Smith - Damn You For Breaking My Heart
Local Natives - Nova
QUIN - Fav (feat. 6LACK)
03 Greedo - Maria
Jay Park - Renaissance Man
Elyanna - Oululee Leh
Princess Nokia - Balenciaga
BAMBII - NITEVISION
Lil Benny - Ed Hardy
ren - idc
Baby Rose - August 5th
Austin Millz - Bad Behavior
Tei Shi - Matando
Hitmaka - Thot Box (Remix) [feat. Young MA, Dreezy, Mulatto, Dream Doll, Chinese Kitty]
Royce Da 5'9" - Black Savage
Blac Youngsta - Goodbye (feat. Yo Gotti & Moneybagg Yo)
Big K.R.I.T. - Ballad of the Bass (My Sub V)
Ama Lou - We tried, we tried.
sophie meiers - come ovr
Milky Chance - Oh Mama
James Hersey - Hands On Me
Katie Pruitt - Out Of The Blue
ROZES - Walls
CAL - AFU
Maude Latour - Lovesick
marcos g - dancefloor
Hoops - They Say
Saul - Trial By Fire
Fredo Bang - Cap A Lot
Styles P - Blam, Blam, BlamEmbed Tongue Tied (with YUNGBLUD & blackbear) Tongue Tied (with YUNGBLUD & blackbear) Marshmello;YUNGBLUD;blackbear progressive-house