2 ContributorsNew Music Friday 10/04/19 LyricsTravis Scott - HIGHEST IN THE ROOM
Camila Cabello - Cry for Me
Dan + Shay - 10,000 Hours (with Justin Bieber)
Ali Gatie - Used to You
Lauv - Sims
Summer Walker - Come Thru (with Usher)
Charlie Puth - Cheating on You
Niall Horan - Nice To Meet Ya
Dermot Kennedy - All My Friends
Halsey - clementine
Doja Cat - Bottom Bitch
Chris Brown - Overtime
SuperM - Jopping
YK Osiris - Ride (feat. Kehlani)
Gucci Mane - Big Booty (feat. Megan Thee Stallion)
Sabrina Claudio - Rumors (feat. ZAYN)
Russ - OLD DAYS
Surfaces - Good Day
Juice WRLD - Bandit (with YoungBoy Never Broke Again)
Pia Mia - Don't Get Me Started
CHVRCHES - Death Stranding
King Princess - Hit the Back
FINNEAS - Lost My Mind
Tom Walker - Better Half of Me
Carly Rae Jepsen - Don't Speak - Recorded At Spotify Studios NYC
Lost Frequencies - Beat of My Heart
88rising - These Nights
Wale - Love & Loyalty (feat. Mannywellz)
Majid Jordan - Superstar
Jessie Reyez - Far Away
Angel Olsen - New Love Cassette
bülow - Own Me
Kim Petras - There Will Be Blood
X Lovers - Play Your Game
Peach Tree Rascals - Mango
Carly Rose - getaway car
Silver Sphere - boys r dumb! duh!
JUMEX - SPRAYPAINT
Highly Suspect - Tokyo Ghoul (feat. Young Thug & Terrible Johnny)
DeathbyRomy - Problems
Danny Brown - uknowhatimsayin¿
Pop Smoke - War
Quin Nfn - Hold You Down
Mike Posner - Legacy
R.LUM.R - Lonely
Rema - Spaceship Jocelyn
Party Pupils - One Two Things (feat. TOBi)
Monsta X - SOMEONE'S SOMEONE
David Guetta - Jump
BlocBoy JB - ChopBloc 2 (feat. NLE Choppa)
Kid Ink - Randy Mo$$
Guapdad 4000 - Gucci Pajamas (feat. Chance the Rapper and Charlie Wilson)
Abraham Mateo - ¿Qué Ha Pasao'?
Kat Saul - I Love To Hate You
Barrie - Drag
DIIV - Like Before You Were Born
Skegss - Save It For The Weekend
Wilco - Everyone Hides
The Avett Brothers - Tell The Truth
Maddie & Tae - Everywhere I'm Goin'
ayokay - Dear Luca
MIKA - Ready To Call This Love
Melii - Nena
Kash Doll - Mobb'n
Fabolous - Choosy (feat. Jeremih & Davido)
Big Gigantic - Where I Wanna Be
Gesaffelstein - ORCK
ARTY - Daydreams
Anthony Ramos - Mind Over Matter
Jesse & Joy - Tanto
Diana Gordon - Becoming
Justin Rarri - TREESHA
Take A Daytrip - Louis (feat. Jesse)
Claud - Want To
Maisie Peters - Adore You
VOILÀ - Water
City and Colour - Difficult Love
Ama Lou - NORTHSIDE
T.R.U. - Shoot It Out (feat. Worl & Hott LockedN)
Dave East - Alone (feat. Jacquees)
Jelani Aryeh - Jetfuel
gnash - forgive
Isaac Dunbar - body
Big Thief - Forgotten Eyes
Liza Anne - Devotion
Niko Moon - WAY BACK
Brantley Gilbert - Fire & Brimstone
Third Eye Blind - The Kids Are Coming (To Take You Down)
Jackson Penn - My Girl
Jez Dior - On My Own
Healy - Tucson
Ant Clemons - 4 Letter Word
WizKid - Joro
Godfather of Harlem - Cross the Path (feat. Swizz Beatz, A.CHAL & Jidenna)
Peewee Longway - Long Money
KIDDO - Dead Alive
BANNERS - No One Knows Us
The Who - All This Music Must FadeEmbed 10,000 Hours (with Justin Bieber) 10,000 Hours (with Justin Bieber) Dan + Shay;Justin Bieber country