2 ContributorsNew Music Friday Christian 02/01/19 LyricsMichael W. Smith - Waymaker (feat. Vanessa Campagna, Madelyn Berry)
Jonathan McReynolds - Make Room (Radio Edit)
Dariann Gonzalez - You
Chris Tomlin - Is He Worthy? (Live)
The Ruins - Deliverance
Gabi Sampaio - Na Terra Como no Céu (Here As In Heaven) (feat. Weslei Santos)
Koryn Hawthorne - Unstoppable (feat. Lecrae)
George Strait - God And Country Music
C3 NYC  - I See The Promise
Luke + Anna Hellebronth - Abide
Felipe Santos - Expectativa
Donald Lawrence, The Tri-City Singer - YHWH (The Sound of My Breathing) (feat. Jekalyn Carr)
Jess Ray - Did Not Our Hearts Burn
Home Free - Great Day To Be Alive
*David Leonard - Know Your Heart
Mel Crothers - I Am Held
Chris Tomlin - Is He Worthy? (Acoustic) (feat. Andrew Peterson)
JJ Heller - It'll Be Alright
Hyper Fenton, Moflo Music - Chillin' In Dallas
Chris Howland - Love You More
Tobe Nwigwe - ODE TO FAT (feat. DAVID MICHAEL WYATT)
Isra y Vale - Incomprehensible
Soly - Solo Uno (feat. Jownah)
Asaph - Oh, the deep
Gods Posse - Anchored
Ghidee Dar Bishop - Bowale
Becca Bradley - Jealous
Bethel Music, Christine D'Clario - Promesas (Live)
ON / OFF / ON - Weathered Palms
Paulo Neto - Ressurreição em Naim
Tamara Lebak - Holy Mountain (Psalm 2)
David Dimaguila - Burn
Jess Ray - Morning Song
The Porter Brothers - Sound of Victory (Radio Edit) (Live) (feat. Mlk Celebration Choir)
Rich Rock - Self-Made
Influence Music, Whitney Medina, Sarmo - Touching Heaven (Sarmo Remix)
Jonathan Jackson - One in a Million
Yemi Alafifuni - Padre
Elevation Worship - Encuéntrame Otra Vez (Here Again)
Jesua - Mas Que un Sueño
Jonathan Burkett - One Life (feat. Amblique)
Tony Moore - Only Love Can Heal You
Truevined - Wate a Minute
Dru Bex - No Treadmill (feat. Not Klyde, Kid Tris)
Deep Wells Worship - One I Love
Haynza - Young
Mike Guess, Advo - No Worries
Narrow Skies - Season of Gold
Ayanda Khumalo - This Is Amazing Grace (Live)
Deborah Dworshipper - I See the Light
United Generation - In Your Presence (feat. Held by Nails)
Corey Voss - More Than Anything (Live) (feat. Madison Street Worship, Olivia Calderwood)
E-Surv - Money Answers All Things
Bethel Music, Bethany Wohrle - Mi Esperanza Está en Jesús (Live)
JC Kroupa - Meant for Him (feat. Cypert)
Aaron Thomas Walsh - Chaos to Calm
West Pines Worship - Not by Might
Camila Holanda - Aprendiz
Daggerwing - Undivided Heart (feat. Jessica Newhof)
Danpho - Not Worried
1910 Worship - Life + Love
Vida Music - Give In (feat. Courtney Huesties)
Jordan Smith - Your Eyes
Desperation Worship - Patient King
Newsflash Singers - Redemption Harbour
Kevin Aleksander - Day N Night
CHURCHOUSE - There's a Name (feat. Chris Clayton)
Bethel Music, Kalley Heiligenthal - Por Siempre (Live)
Gissela - Reckless Grace
Southside Worship - Peace Came Down (Live)
SoulBox - Nothing Outside of Your Love
Jaydan - Quién Contra Mi?
MountainCity - Darling I Do
Onell Diaz - Regresa
Crystal Rome - Morning
Trelic - Proud
oYYo - City Lights
Jim Brickman - My Love Is Here
Salomon - Weibes Blatt
Tendre - Fresh
Maestro Musik - On My Own
Rhymer/Educator, WittiestMC - Meant for Me
Bryan Boliver - Words of Praise
Garrett Jacobs - The Healing
JC Dirks - No Other
SoulBox - Falling into You
Charles Goose - joy comes in the morning
JDR - Lo Volverás a Hacer
Fedel - I Will Not Lose
Yeyo - Te Amarea Ciegas
Tall J - Beatin' Down
Homegrown Worship - Faithfulness
Arieta Magrini - Oh Quão Lindo Esse Nome É
Nil Moliner - El despertar
TAVIA - Solstice
Kyle Church - Your Love Will Find Me
Jerry Hernandez-Zabala - Todo Se Lo Debo a Él (Version Salsa)
Brian Ortize - Only Jesus (feat. London Gatch)
Liturgies - Passing Time
Deane Walden - Lanes Switched (feat. J. Crum)
Miraql3, Altitan - FADEAWAY
Andie Elise - Sunsets of Zion (feat. Branson Long)
Mainstream Worship - In Your Love (Live)
Frankie Barranco - Call to Mind
We Are Vessel - Holding On
James - Relapse
Pyramid Park - Father Father (Acoustic Version)
Flame, Wes Writer - Woke Up This Morning
London Philharmonic Orchestra, Ian Mulder - Turn Your Eyes Upon Jesus
Edo Saiya - Highway
Deraj - Games
DJ Mykael V, Phil J, Joe Ayinde - Better Dayz
Xay Hill, Bl1nd3d - Level 7
Royal Company - Found in You
Noah Kwaku - Sweet
Vineyard Worship - You're Carrying Me (feat. Joshua Miller)
DappyTKeys - Fill This Place
Blutengel - Morningstar
Samy Gali - Dios de Maravillas (Solo Piano)
Fatki, SK-Hall - WaitingEmbed Waymaker - Radio Version Waymaker (Radio Version) Michael W. Smith;Vanessa Campagna world-music