1 ContributorNew Music Friday 02/04/22 LyricsNicki Minaj - Do We Have A Problem?
Juice WRLD - Cigarettes
Tate McRae - she's all i wanna be
Labrinth - I'm Tired - From "Euphoria" An Original HBO Series
Machine Gun Kelly - emo girl (feat. WILLOW)
ROSAL√çA - SAOKO
Mitski - Stay Soft
King Von - Don't Play That
YG - Scared Money (feat. J. Cole and Moneybagg Yo)
Arlo Parks - Softly
Flume - Say Nothing (feat. MAY-A)
Jim-E Stack - Next To Me
$NOT - Doja
2 Chainz - Neighbors Know My Name
Queen Naija - Hate Our Love (with Big Sean)
Jax Jones - Where Did You Go?
Jennifer Lopez - Marry Me - Kat & Bastian Duet
Bastille - Back To The Future
BENEE - Beach Boy
Red Hot Chili Peppers - Black Summer
Dr. Dre - Gospel (with Eminem)
Adekunle Gold - FYE
Labrinth - Yeh I Fuckin' Did It - From "Euphoria" An Original HBO Series
Oliver Tree - Freaks & Geeks
Ali Gatie - Perfect
John Legend - Tomorrow
Luna Li - Silver Into Rain
Saba - Still (feat. 6LACK and Smino)
Yo Gotti - Cold Gangsta
Sofi Tukker - Original Sin
Hippo Campus - Bang Bang
Wallows - Especially You
Winnetka Bowling League - fiimy - fuck it, i miss you
Keshi - TOUCH
Yung Gravy - Hot Tub
22Gz - Said It‚Äôs Lit
E-40 - It's Hard Not To
Koffee - Pull Up
Russ - HANDSOMER
Allen Haley - TAKEN BACK
WizTheMc - Premature Love
Hope Tala - Party Sickness
Lyn Lapid - I Guess That Was Goodbye
Kassi Ashton - Dates In Pickup Trucks
Calum Scott - If You Ever Change Your Mind
K.Flay - The Muck
DEKKO - Kelede
Tai'Aysha - One Night Ting (feat. Saweetie)
Shouse - Won't Forget You - Edit
DRAMA - 3AM
Jay Safari - Dance
B-Lovee - Don't Change
BIG30 - Protest
Stunna Gambino - Evil
BEAM - PLANET BEAM
Yeule - Bites on My Neck
Goth Babe - Running Around
Alfie Templeman - Broken
Lucy Dacus - Kissing Lessons
Lupe Fiasco - Hustlaz
12AM - Showgirls
Arizona Zervas - BAND$
Jason Aldean - Rock And Roll Cowboy
Cole Swindell - I'm Gonna Let Her
Maddie Zahm - Fat Funny Friend
Maddie Jay - Gutterball
Mallrat - Your Love
Mont Duamel - Days With You
Animal Collective - We Go Back
Cate Le Bon - Harbour
Alok - Side Effect (feat. Au/Ra)
Peking Duk - Honest (feat. Slayyyter)
Tay Money - Hello (with Saucy Santana)
Conway the Machine - John Woo Flick (with Benny The Butcher & Westside Gunn)
ArrDee - War
Sampha - In-between and Overseas
Kyle Dion - HAZY
Tayo Sound - Two Left Feet (feat. Oscar Scheller)
Hans Williams - All Is Well
Wild Rivers - Stubborn Heart
Erin Kinsey - Hate This Hometown
Peach PRC - God Is A Freak
Arden Jones - daisy
A-Wall - Nightcrawler
Nia Archives - Luv Like
LAYA - Brag (feat. Fivio Foreign)
Yung Kayo - everything new (feat. Gunna)
Jay Critch - Born With It
Liam Gallagher - Everything's Electric
Johnny Dailey - Trouble
Erin Rae - Can't See Stars (feat. Kevin Morby)
Mahmood - Brividi
Baby Money - Who Not Turnt
Iayze - C'mere!
Reyanna Maria - Loser
Danielle Apicella - Cold üïí
AVIV - You Feel Like Depression
Hamond - Angels üïí
The Golf Club - funny lil thing
Korn - ForgottenYou might also likeEmbed Side Effect (feat. Au/Ra) Side Effect (feat. Au/Ra) Alok;Au/Ra house