2 ContributorsNew Music Friday 06/05/20 LyricsRun The Jewels - JU$T (feat. Pharrell Williams & Zack de la Rocha)
YG - FTP
Sleepy‚ÄÖHallow‚ÄÖ& Fivio Foreign‚ÄÖ- Baddie Betty Boop
Lil Wayne -‚ÄÖHelp (with Tory Lanez)
Tee Grizzley - Mr. Officer (feat. Queen‚ÅüNaija‚Åüand‚Åümembers of the‚ÅüDetroit Youth Choir)
Dua‚ÅüSaleh - body cast
Conway the Machine - Front Lines
XXXTENTACION - Riot
JayDaYoungan - Do Your Dance (feat. Moneybagg Yo)
Mickey Guyton - Black Like Me
The Blind Boys Of Alabama - Stay On The Gospel Side
Run The Jewels - out of sight (feat. 2 Chainz)
SEB - Boys Don't Cry
Joy Oladokun - Who Do I Turn To?
Flatbush Zombies - dirty elevator music
Terrace Martin - Pig Feet (feat. Kamasi Washington, G Perico & Daylyt)
Eric Bellinger - ENOUGH
Nadia Rose - Too Bad
Baby Rose - Show You (Remix) [feat. Q] [from Insecure: Music From The HBO Original Series, Season 4] (üêö)
Raleigh Ritchie - Party Fear
Marlon Craft - Airplane Mode
Willie Jones - Trainwreck
Mt. Joy - Bug Eyes
Bruno Major - I'll Sleep When I'm Older
LA Priest - Rubber Sky - Edit
Ninajirachi - Alight
TWICE - MORE & MORE
Joey Trap - HOLY GHOST
IAMDDB - Quarantine (Prod.by Adrian)
Torrentiiial - Sweet Tooth Baby (üêö)
Navvy - Pieces
Okay Kaya - Snacks
DVBBS - Tinted Eyes (feat. blackbear & 24kGoldn)
RIZ LA VIE - Something Cosmic
Sports Team - Camel Crew
will hyde - easy for u.
Benjamin Carter - Fragile (feat. Appleby)
Faithless - Let the Music Decide - Edit
Astrid S - Dance Dance Dance
Natti Natasha - Que Mal Te Fue
Hinds - Burn
Rah Swish - WOO Forever
Big Havi - Dope Sh*t (feat. D'Rick) (üêö)
Halima - Wake Up!
Jekalyn Carr - Changing Your Story
Allan Rayman - Completely
Gordi - Unready - aO2Sk
The Aces - Kelly
R3HAB - B√©same (I Need You) (with TINI & Reik)
Two Door Cinema Club - Tiptoes
Bryce Xavier - bus ride away
Sammie - Such Is Life
Scarlxrd - BLK XN BLK.
Bambino - Esperanza
AKA George - i want you
LOVA - Black Converse
Half Moon Run - All at Once
Eves Karydas - Complicated
Elvis Costello - No Flag
Rolling Blackouts Coastal Fever - Cameo
sophiemarie.b - Call Me Up
Griffin Oskar - Answer
Becca Mancari - Lonely Boy
Dougie Poole - The Who's Who of Who Cares (üêö)
Benjamin Ingrosso - Shampoo
Aquilo - Always Forever
Lilacs. - Got No Love (feat. G Lun√© & mikefellow)
Bickleboy - Actor
Ncognita - Hallucinogen (Trippin') (üêö)
Dany Neville - Next Day (üêö)
Ronny J - Miami
NZCA LINES - Prisoner of Love
Skiibii - Banger (üêö)
Caroline Kole - Still Frames
New Atlas - Jet Black
Keeka - Hold Up
Marsicans - These Days
Sarah Jarosz - Hometown
Blanco White - I Belong to You
duendita - yaya my favorite
Ball Park Music - Day & Age
Marlhy - See You Soon
Trella - Fumes
RAIZA BIZA - A Piano Song
Anna Dellaria - Cut You Loose
Nick De La Hoyde - Lay Low
ohsobrkn - Ghost Next Door
Kelvin Boj - Looku Looku
Feiertag & James Alexander Bright - It's Alright
emir taha - 7 Cigs
Voodoos - Going South
Ghostly Kisses - Stay
toast - strawberry lemonade
Jaspa - Blues to Green (üêö)
Harrison Storm - Breathe AgainEmbed Tinted Eyes (feat. blackbear & 24kGoldn) Tinted Eyes (feat. blackbear & 24kGoldn) DVBBS;24kGoldn;blackbear electronic