2 ContributorsNew Music Friday 01/08/16 LyricsShakira - Try Everything
Sia - Reaper
Wild Belle - Throw Down Your Guns
Wet - All the Ways
Billie Ellish - Ocean Eyes (Astronomyy Edit)
DJ Mustard - Whole Lotta Lovin' feat. Travi$ Scott
St. Lucia - Love Somebody
Will Joseph Cook - Streets of Paris
LOYAL - Blue & The Green
Madison Beer - Something Sweet
Tank - #BDAY feat. Chris Brown, Siya & Sage The Gemini
Gallant - Blue Bucket of Gold feat. Sufjan Stevens
Prom - Not About Dying
ASTR - Activate Me feat. Hoodboi (Hoodboi Remix)
Yeasayer - I Am Chemistry feat. Suzzy Roche
Chairlift - Crying in Public
WrongONyou - Killer
The Hunna - We Could Be
Demi Lovato - Stone Cold (Live from Spotify NYC)
Pitbull - Freedom
Marshmello - Keep It Mello feat. Omar LinX
Porches - Be Apart
Conrad Sewell - Shadow
Pete Yom - Lost Weekend
Above & Beyond - Peace of Mind feat. Zoe Johnston (Extended ABGT Mix)
Blossoms - At Most a Kiss
White Denim - Holda You (I'm Psycho)
Cam - My Mistake (Live from SXSW 2015)
Ron Pope - Southern Cross
Savages - Adore
Pell - Pretty Things
Blajk - French Class
Wild Nothing - Reichpop
Dr. Dog - Bring My Baby Back
Charles Kelly - Lonely Girl
AudioDamn! - Radar
Mavis Staples - High Note
Lady Leshurr - Queen's Speech 5
Boosie Badazz - Roller Coaster Ride
Rich Homie Quan - Color Purple feat. Young Thug
Tender - Afternoon
Popcaan - Fiesty Chat
David Bowie - Girl Loves Me
Fleurie - Sirens
Aoife O'Donovan - Porch Light
Sunflower Bean - Easier Said
Brothers Osborne - It Ain't My Fault
Linney - That Night
MÃ¶we - Lovers Friends feat. Daniel Nitt
Disclosure - Omen (Dillon Francis Remix) feat. Sam Smith
Modern Space - It's Only A DreamEmbed Keep It Mello (feat. Omar LinX) Joytime Marshmello;Omar LinX progressive-house