2 ContributorsNew Music Friday 06/08/18 Lyrics88rising - Midsummer Madness feat. Joji, Rich Brian, AUGUST 08 & Higher Brothers
Chelsea Cutler & Jeremy Zucker - Lonely Alone
DeJ Loaf - Liberated feat. Leon Bridges
Witt Lowry - Into Your Arms feat. Ava Max
Sabrina Carpenter - Almost Love
Jorja Smith - Goodbyes
Shakira - Clandestino feat. Maluma
Jeremih & Ty Dolla $ign - The Light
Khalid & H.E.R. - This Way
Ruel - Younger
Tory Lanez & Ozuna - Pa Mi
Christina Aguilera - Like I Do feat. GoldLink
Mason Ramsey - Love Sick Blues
Jauz & Kiiara - Diamonds
Roy Woods - Russian Cream
Rich The Kid - Bring It Back
Yellow Claw & DJ Snake - Public Enemy
Lewis Capaldi - Tough
Little Big Town - Summer Fever
Gorillaz - Sorcererz
Dagny - Used To You
Vic Mensa - Reverse feat. G-Eazy
Thomston - Acid Rain
Future - Walk On Minks
Cheat Codes - Activate
Drax Project - Only Us
Gnash - imagine if
Amy Shark - Don't Turn Around
You Me At Six - 3AM
Lykke Li - last piece
Tim Mason - Najona
Kane Brown - Lose It
Bülow - You & Jennifer
Phoebe Ryan & Quinn XCII - Middle Finger
Marshmello - Tell Me
Charlotte Lawrence - Young and Reckless
Lily Allen - Come On Then
James Blake - Don't Miss It
Social House - Magic In The Hamptons
Yoke Lore - Cut and Run
John Mark McMillan - Wilderlove feat. Joy Williams
NEEDTOBREATHE - Bullets
Dierks Bentley - Goodbye In Telluride
Youngr - Lost In Translation
Masego - Lady Lady
Jay Rock - The Bloodiest
Shy Glizzy - Do You Understand? feat. Gunna & Tory Lanez
Sky, J Balvin & Ozuna - Karma
Ne-Yo - NIGHTS LIKE THESE feat. Romeo Santos
Kota Banks - Fiorentina feat. Capo Lee
MAGIC! - Kiss Me
Why Don't We - Hooked
Kim Petras - Can't Do Better
Mike Shinoda - Ghosts
The Smashing Pumpkins - Solara
One Acen - E I O feat. Hardy Caprio
Pusher - Sober feat. Soren Bryce
Taylor Bennett - BE YOURSELF feat. bianca shaw
UnoTheActivist - Lil Flip
Tyler, The Creator - 435
Interpol - The Rover
Cordovas - This Town's A Drag
Wolfgang Gartner - The Upside Down feat. JayKode
L.I.F.T - Locked Up
GRAVEDGR - RAMPAGE
Benji Lewis - Us Again
Global Dan - Lil Skies
LIVVIA - Gratitude
Chief Keef - Gang Gang
OK MAYDAY - Cut Too Deep
Radiant Children - Life's a Bitch
Total Ape - In a Haze
Møme - When We Ride feat. JPL
Pendulum - The Island, Pt. 1 (Dawn) (Skrillex Remix)
Norah Jones - My Heart Is Full
Pat Barrett - Into Faith I Go
Cappa - Tension
Tove Lo - bitches feat. Charli XCX, Icona Pop, Elliphant & ALMA
KATIE - Remember
Birdtalker - Outside the Lines
Braxton Cook - Never Thought (quickly, quickly Remix)
Badflower - Ghost
Thrice - The Grey
Wild Nothing - Letting Go
Roo Panes - Sketches of Summer
Lao Ra - No Pressure
Hillsong Young & Free - Just Jesus
The Manor - Tyson Fury feat. Donae'o
Bob Sinclar - I Believe
Snail Mail - Golden Dream
Sabina Ddumba - Small World
Dave Matthews Band - She
SahBabii - Watery
THEY. - Pops
Passenger - Why Can't I Change
Fetty Wap - Strawberry Kush
Becky Hill - Sunrise In The East
Seth Ennis - Call Your Mama1Embed Into Your Arms (feat. Ava Max) Into Your Arms (feat. Ava Max) Witt Lowry;Ava Max pop