3 ContributorsNew Music Friday 07/28/17 LyricsJulia Michaels - Worst In Me
Charli XCX - Boys
Skrillex & Poo Bear - Would You Ever
Kesha - Learn To Let Go
Thomas Rhett - Unforgettable
The Killers - Run For Cover
Snakehips & Anne-Marie - Either Way feat. Joey Bada$$
Future - You Da Baddest feat. Nicki Minaj
Purity Ring - Asido
Elohim - Sleepy Eyes feat. Whethan
Blackbear - do re mi feat. Gucci Mane
Dimitri Vegas & Like Mike & David Guetta - Complicated feat. Kiiara
Macklemore - Marmalade feat. Lil Yachty
Lil Pump - Ok feat. Smokepurpp
PnB Rock - Feelins
Arcade Fire - Chemistry
BØRNS - Faded Heart
Ella Vos - In Your Corner
Aminé - Spice Girl
NoMBe - Bad Girls
Canon Blue - Beholden
Gryffin - Love In Ruins feat. Sinead Harnett
Luke Christopher - Can't Sleep
Joan - love somebody like you
G4SHI - 24 Hours
Coast Modern - Run It Up
Passion Pit - I'm Perfect
Joywave - Little Lies You're Told
Phora - Snakes
Jessie Ware - Midnight
James TW - Please Keep Loving Me
Capital Kings - Don't Wanna Wake Up
James Cherry - On My Mind
Dave East - Perfect feat. Chris Brown
KWAYE - Sweetest Life
DaVido - Pere feat. Rae Sremmurd & Young Thug
Vic Mensa - We Could Be Free feat. Ty Dolla $ign
Cheat Codes & Nicky Romero - Sober
Timeflies - Are We There Yet feat. Chase Rice
Brett Eldredge - No Stopping You
Passenger - Simple Song
Ciaran Lavery - Everything Is Made to Last
DRAM - Cute (Remix) feat. Cardi B
Sabrina Claudio - Belong To You
Dubé - Pretty Girls on Bikes
Benjamin Gibbard - I Don't Know
Billie Eilish - my boy
FRND - Movies
Huntar - Pony feat. Gucci Mane
The Japanese House - Landslide (Recorded At Spotify Studios NYC)Embed Complicated (feat. Kiiara) Complicated (feat. Kiiara) Dimitri Vegas & Like Mike;David Guetta;Dimitri Vegas;Kiiara house