11 ContributorsJanuary 2021 Singles Release Calendar Lyrics1/1
Andrew McMahon in the Wilderness - "New Year Song"
Bailey Bryan - "Sober"
EGOVERT - "Do It!" ft. Smokepurpp
Foo Fighters - "No Son of Mine"
Hannah Grace - "Wonderful Way"
Jeff Rosenstock - "Illegal Fireworks and Hiding Bottles in the Sand"
JUNG - "Heaven"
Justin Bieber - "Anyone"
Kieran S - "Haunt Me"
Mitchell Tenpenny - "Bucket List"
Molly Burch - "Emotion" ft. Wild Nothing
OBN Dev - "Scam Bible 2"
Olivia O'Brien - "Better Than Feeling Lonely"
Parker McCollum - "To Be Loved by You"
SAFE - "TTG"
Sarah Klang - "Agony"
Sa Vich - ''Car Keys'' ft. Flixman
Smith & Thell - "Radioactive Rain"
SYML - "TRUE"
Thouxanbanfauni - "Outside"
Xan Griffin - "Lightly" ft. Lani Rose
You Me at Six - "Adrenaline"
Buppy. - "Violence"
1/2
Jaebanzz - "2 Blind"
Yameii Online - "Void"
1/3
YN Jay - "HAHAHA" ft. Lil Yachty

1/4
Benny the Butcher - "Bills Mafia Anthem"
Big Ghost LTD. & Conway the Machine - "Toast"
Deko - "Excelsior"
JIMMY EDGAR & Matt Ox - "PAUSE"
London Grammar - "Lose Your Head"
Madlib - "Hopprock"
OMB Peezy - "Be This Way"
1/5
Bas & the Hics - "Smoke from Fire"
Key Glock - "Off the Porch"
Leslie Odom Jr. - "Speak Now"
slowthai & A$AP Rocky - "MAZZA"
Trendy - "Took Her to da Club" ft. Lil Boom
Westside Gunn, Smoke DZA & Wale - "The Hurt Business"
White Gold - "Many Faces"
1/6
Alice Glass - "SUFFER AND SWALLOW"
Cheat Codes - "No Chill" ft. Lil Xxel
Doe Boy & Babyface Ray - "Walk Down Again"
Jazmine Sullivan - "Girl Like Me" ft. H.E.R.
Sangam - "Future on Hold"
Shame - "Nigel Hitter"
Unlike Pluto & why mona - "Quintana Roo"
Viagra Boys - "Girls & Boys"
YOASOBI - "Monster"
1/7
Arlissa - "Rules"
Bugzy Malone - "Notorious" ft. Chip
glass beach - "beach life in death"
Kings of Leon - "100,000 People"
Kings of Leon - "The Bandit"
Lokoy - "relay" ft. Nils Bech
NAO - "Antidote" ft. Adekunle Gold
Rhye - "Come in Closer"
Saweetie - "Best Friend" ft. Doja Cat
Vagabon - "Reason to Believe" ft. Courtney Barnett

1/8
8ubbles - "Happy Birthday 2 U"
Alexander Oscar - "January"
Azealia Banks & Slim Dollars - "Six Flags"
Black Honey - "Believer"
Bob Moses & ZHU - "Desire (Vintage Culture & Kiko Franco Remix)"
CamelPhat & Green Velvet - "Critical"
Caramella Girls - "Samurai (Karaoke Mix)"
Caramella Girls - "Samurai (Radio Mix)"
Catie Turner - "Play God"
Charlotte Lawrence - "Talk You Down"
Christopher - "Good to Goodbye" ft. Clara Mae
David Bowie - "Mother"
David Bowie - "Tryin' to Get to Heaven"
Deadmau5 - "Channel 43" ft. Wolfgang Gartner
Desiigner - "AMEN"
Dua Lipa & Angèle - "Fever (Feder Remix)"
Dua Lipa & Angèle - "Fever (Myd Remix)"
Dua Lipa & Angèle - "Fever (Vantage Remix)"
Duran Duran - "Five Years"
​dvsn - "Use Somebody"
Echosmith - "Tell Her You Love Her (Remix)" ft. Mat Kearney
Esmée Denters - "Minimalist"
Florida Georgia Line - "New Truck"
Galantis & JVKE - "Dandelion"
Haley Reinhart - "Heroes"
JC Stewart - "Break My Heart"
Jhay Cortez & Myke Towers - "Los Bo"
LANDMVRKS - "Paralyzed"
Like Saturn - "set adrift"
Linkin Park - "One Step Closer (100 gecs Reanimation)"
Lucy Spraggan - "Animal"
Mad Clip, Jay Critch & Mike G - "Overseas"
Manuru - "Black December"
MOD SUN - "Flames" ft. Avril Lavigne
Moses Mosima & Carter Fox - "Different"
NERVO & Carla Monroe - "Gotta Be You"
Odette - "Amends"
Ofenbach - "Wasted Love" ft. Lagique
Olivia Rodrigo - "drivers license"
Ray Dalton - "Don't Make Me Miss You"
RMR - "Her Honeymoon"
Rozzi - "Hymn for Tomorrow"
Rxseboy - "Jimmy" ft. Sarcastic Sounds
Run the Jewels - "JU$T (What So Not Remix)" ft. Pharrell Williams & Zack de la Rocha
Russ - "Ugly" ft. Lil Baby
Ryland James - "Blame"
Sinéad Harnett - "At Your Best (You Are Love)"
The Fratellis - "Action Replay"
The Pretty Reckless - "And So It Went" ft. Tom Morello
Tom Grennan - "Little Bit of Love"
Tom Speight - "Everything's Waiting for You"
Two Feet - "Fire"
Vaishalini - "So You Need Me Now?"
VanJess - "Curious" ft. GARREN & Jimi Tents
Virgil Abloh - "Delicate Limbs" ft. serpentwithfeet
Yameii Online - "No Error"
YG, D3SZN & Day Sulan - "Hit Em Up"
Zara Larsson - "Talk About Love" ft. Young Thug
ZAYN - "Vibez"
1/9
Matt Ox - "TRIPPLE DIP"
Mutilomaquia - "The absence of truth is not just an aesthetic choice"
1/11
Andra Day - "All of Me"
Black Country, New Road - "Track X"
Blanck Mass - "Starstruck"
Danny Elfman - "Sorry"
Dayglow - "Close to You"
Deko - "BUSS!" ft. Yameii Online
(G)I-DLE - "화(火花) (HWAA)"
Gary Numan - "Intruder"
Key Glock - "Dubai Plates"
Key Glock - "Flavor Flav"
Lana Del Rey - "Chemtrails Over the Country Club"
Oracle FM - "hit the table"
Sleaford Mods - "Nudge It" ft. Amyl and the Sniffers & Amy Taylor

1/12
Ashnikko - "Deal with It" ft. Kelis
BAND-MAID - "Manners"
Bicep - "Sundial"
Blacc Zacc - "Plenty Bad Bitches" ft. Lul Eli
Claud - "Cuff Your Jeans"
dodie - "Hate Myself"
G Flip - "Queen" ft. mxmtoon
​guccihighwaters - "Hold Somebody" ft. Sarcastic Sounds & Powfu
​guccihighwaters - "Rock Bottom" ft. nothing,nowhere.
Mogwai - "Ritchie Sacramento"
Teenage Wrist - "Yellowbelly"
will.i.am - "American Dream"
Zoe Wees - "Girls Like Us"
1/13
Baby Queen - "Raw Thoughts"
Cat & Calmell - "dramatic"
Charlotte Cardin - "Daddy"
Doe Boy & Veeze - "NCAA"
Dolapo, Ms Banks & Oxlade - "Interest"
Emmit Fenn - "Edge of the Dark"
Emotional Oranges - "Bonafide" ft. Chiiild
JP Saxe & Maren Morris - "Line by Line"
Julien Baker - "Hardline"
Lael Neale - "Blue Vein"
Lil West - "TMZ!"
Luna Shadows - "nite swim"
Momoiro Clover Z - "月色Chainon"
Noga Erez - "End of the Road"
Nyck Caution - "Bad Day" ft. Denzel Curry
Of Mice & Men - "Obsolete"
Orla Gartland - "More Like You"
Pale Waves - "Easy"
Rochelle Jordan - "Got Em"
Tim McGraw & Tyler Hubbard - "Undivided"
Unlike Pluto - "Poster Boy"
1/14
Always Never - "Set Me on Fire"
Ameer Vann - "IDFIATOK"
Danny L Harle - "On a Mountain"
Ebhoni - "Hit This"
Foo Fighters - "Waiting on a War"
G Flip & mxmtoon - "Queen"
Hunter Hayes - "The One That Got Away"
Jae Stephens - "What You Need" ft. THEY.
Joshua Bassett - "Lie Lie Lie"
Middle Kids - "Questions"
Night Lovell, Lindasson & FTG Reggie - "A Lot"
Parker Millsap - "The Real Thing"
Sia - "Hey Boy (Remix)" ft. Burna Boy
Squash - "Big up Yuh Self"
1/15
Aly & AJ - "Listen!!!"
Ani DiFranco - "Simultaneously"
Anne-Marie, KSI & Digital Farm Animals - "Don't Play"
Annika Wells - "Fuck Being Sober"
Ariana Grande - "34+35 (Remix)" ft. Megan Thee Stallion & Doja Cat
ATB, Topic & A7S - "Your Love (9PM)"
Audrey Mika - "Excuses"
Avenue Beat - "WOMAN"
Baio - "Dead Hand Control"
Bianca - "Last Weekend"
Bizzy Banks - "Bandemic"
Black Coffee & Diplo - "Never Gonna Forget" ft. Elderbrook
Blake Shelton - "Minimum Wage"
Chapel - "Pillow Talk"
Chip - "Lumidee" ft. Young M.A & Young Adz
Christian Leave - "Your Life Your Time"
DaBaby - "Masterpiece"
DIVINE - "Jungle Mantra" ft. Vince Staples & Pusha T
DREAMERS, American Teeth & Wes Period  - "Still Not Dead"
Elle Winter - "Sad Girl Heaven"
Emilie Nicolas - "Who’s Gonna Love You (Remix)" ft. Isah
Everyone You Know - "When the Sun Comes Up"
Faouzia & John Legend - "Minefields (Hook N Sling Remix)"
Flo Milli - "Roaring 20s"
Florida Georgia Line - "Life Rolls On"
Friedberg - "Lizzy"
Funkmaster Flex & Fivio Foreign - "Game Time"
Futuristic & Michael Minelli - "Ghost"
Gallant - "Comeback."
Georgia Twinn - "Raccoons"
Ghetts - "Skengman" ft. Stormzy
GIRLI - "Passive Aggressive"
Greta Isaac - "Pessimist"
Greyson Chance - "Holy Feeling"
Hailey Whitters - "The Ride" ft. Jordan Davis
Handsome Ghost - "Everything is Alright"
Hayley Williams - "Teardrop"
Ian Munsick - "Humble"
​Isaac Dunbar - "pink party"
Jaguar Jonze - "ASTRONAUT"
Jeff Bernat - "This Time"
Jeremy Zucker & Chelsea Cutler - "this is how you fall in love"
John Grant - "The Only Baby"
John-Robert - "USMO"
Josh A - "Painless"
Joy Oladokun - "wish you the best" ft. Jensen McRae
JP THE WAVY - "I WANT ONE" ft. Kid Milli & Psy.P
Jubël - "Weekend Vibe"
Juice WRLD & Young Thug - "Bad Boy"
K. Forest - "Bad Neighbors"
Kara Marni - "Trippin"
KBFR & Conor Matthews - "WEGO"
Keedron Bryant & Symba - "I Know I Been Changed" ft. Gary Clark Jr.
KEiiNO - "MONUMENT"
Kitten - "Do U Still Love Me?"
Leon Fanourakis - "BEAST MODE" ft. JP THE WAVY
Leony - "Faded Love"
Like Saturn - "fading to grey"
Lil Eazzyy - "Onna Come Up (Remix)" ft. G Herbo
Lil Wayne - "Green and Yellow (Green Bay Packers Theme Song)"
Lindsey Stirling - "Lose You Now" ft. Mako
Logic1000 - "Medium"
Loser - "bonk" ft. koi
Lou Hayter - "Time Out of Mind"
Lous and the Yakuza & Joey Bada$$ - "Amigo"
​lovelytheband - "buzz cut (Remix)" ft. MisterWives
LP Giobbi - "Move Your Body" ft. Hermixalot
Matt Cardle - "Purple Crayon"
Maxïmo Park - "All of Me"
MC Virgins - "Bumpin" ft. Shotgun Willy & Yun Head
Natti Natasha & Prince Royce - "Antes Que Salga El Sol"
Northern Born - "Chomp It"
Now United - "Lean On Me"
Ozuna, AriBeatz & Soolking - "AQUÍ"
Robin Thicke - "Beautiful"
Pooh Shiesty - "Guard Up"
PRAX - "ETHANOL" ft. 916frosty
Rich the Kid - "Split"
RiFF RAFF & Yelawolf - "Tip Toe 4"
Robinson - "How Can I Resist Her"
Running Touch - "Juno"
San Mei - "In the Machine"
scarlxrd - "LET THE WXRLD BURN"
Selena Gomez - "De Una Vez"
Shungudzo - "To be me"
Sofía Valdés - "Lonely"
SORAN - "Bottled Up"
Steve Aoki & k?d - "BIB"
Stina Talling - "Elevate"
The Magician - "One Vibration" ft. CLYPSO
The Plug & M24 - "Fashion" ft. Fivio Foreign
The Wrecks - "Rich Girl"
Tom Jones - "Talking Reality Television Blues"
Tommy Newport - "Yellow Lines"
Trap Jesus - "Spice It Up"
Tyler Shaw - "When You're Home"
UPSAHL - "Drugs (blackbear Remix)"
Welshly Arms - "I Will Overcome"
Wild Youth - "Champagne Butterflies"
Willie Nelson - "That’s Life"
X Ambassadors & Terrell Hines - "ultraviolet.tragedies"
Xan Griffin - "On My Own"
Yameii Online - "Falling"
Yella Beezy - "Is You Fuckin?"
EMMANUEL! - "Diamond" ft. Broken & Sad

1/16
Chip - "10 Commandments"
1/17
The Three Braincells - "Jo Bidden’s Anthem"
1/18
Deko - "i called you sober"
Griff - "Black Hole"
Raylee - "Hero"
Smino - "MLK DR"
1/19
CHUNGHA - "X (걸어온 길에 꽃밭 따윈 없었죠)"
​jxdn - "drivers license"
Kaleb Austin - "Sound of the South"
PnB Rock - "Rose Gold" ft. King Von
That Kid - "Boost Mobile" ft. Terror Jr
Wale - "Good Vibes (Za)"
Young Dolph - "Large Amounts"
Kenny Mason - "Partments"
1/20
Adult Mom - "Sober"
Anna Leone - "Once"
Curtis Waters - "Doodoodoo"
Deb Never - "Someone Else"
Dizzy Wright - "Gas" ft. Trizz
Django Django - "Free from Gravity"
Jacob Sartorius - "youtube & bbq chips"
Joey Bada$$ - "Let It Breathe"
Kid Buu - "Bonnie and Clyde"
Macklemore - "Trump's Over Freestyle"
Mozzy - "Neva Said It"
Sangam - "Waterproof Mask"
Sir Sly - "Citizen" ft. Gary Clark Jr.
​slenderbodies & Crooked Colours - "​superpowerful"
Tate McRae - "​rubberband"
The Vaccines - "No One Knows"
YOASOBI - "優しい彗星 (Comet)"
1/21
ARY - "Moth to a Flame"
Ashanti - "235 (2:35 I Want You)"
Balthazar - "On a Roll"
Billie Eilish & ROSALÍA - "Lo Vas A Olvidar"
Boy in Space - "Dance Alone"
BRS Kash - "Kash App" ft. Mulatto
BRS Kash, DaBaby & City Girls - "Throat Baby (Go Baby) [Remix]"
Brynn Elliott - "Tell Me I'm Pretty"
Dímelo Flow, Sech & Tyga - "Girl Like You" ft. J.I the Prince of N.Y
Fat Joe, DJ Khaled & Amorphous - "Sunshine (The Light)"
glaive & ericdoa - "cloak n dagger"
Jason Derulo - "Lifestyle" ft. Adam Levine
Lil Wayne - "Ain't Got Time"
Lila Downs - "Dark Eyes"
Robin Thicke - "Take Me Higher"
Royal Blood - "Typhoons"
Silk City & Ellie Goulding - "New Love"
The Staves - "Devotion"
Tiësto & Ty Dolla $ign - "The Business, Pt. II"
Weezer - "All My Favorite Songs"
Westside Gunn, Smoke DZA & Wale - "The Hurt Business (Remix)" ft. MVP
Wuki - "Birdz" ft. Smokepurpp

1/22
3OH!3 - "I'm So Sad"
93feetofsmoke - "Appl3"
Angel Haze - "Weight"
Armin van Buuren - "Turn the World Into a Dancefloor (A State of Trance Anthem)"
Ateyaba - "Solitaires" ft. SahBabii
Aura Dione - "Worn Out American Dream"
Birdy - "Surrender"
Charlie Sloth - "Get It" ft. Abra Cadabra, Kelvyn Colt & Gunna
​chillpill - "LiLBiTcH" ft. Rico Nasty & Soleima
CLOVES - "Sicko"
Coi Leray - "No More Parties"
Cosha & Shygirl - "Lapdance from Asia"
Cö Shu Nie - "give it back"
Danitsa - "Let Go"
Dan Caplen - "No Letting Go"
Dark Time Sunshine - "The Rite Kids"
Desiigner - "GLE"
Dennis Lloyd - "Anxious"
Dessa - "Who's Yellen Now?"
Devin the Dude - "To Each His Own"
DJ Chose & Gucci Mane - "You a Dime"
DripReport - "Calvin Kleins"
Duke Deuce - "Soldiers Steppin"
EGOVERT - "Saint Laurent!"
Field Medic - "chamomile"
Florrie - "Garden"
Funkmaster Flex & Rowdy Rebel - "Re Route"
Global Dan - "Too Friendly"
Groundbreaking - "Watch Out"
Hopsin - "Your House"
ILLENIUM, Dabin & Lights - "Hearts on Fire (Lucas & Steve Remix)"
Jasiah - "Unintelligible" ft. Nascar Aloe
Jónsi - "Mold"
KAMILLE - "AYO!" ft. S1MBA
Karen Harding & Shift K3Y - "Morning"
KESMAR - "Delora"
Kiwi Jr. - "Cooler Returns"
Lancey Foux - "Steelo Flow"
LANKS - "Cold Blood"
Lauren Jauregui, Pabllo Vittar & Brabo - "Lento (Brabo Remix)"
Lele Pons & Yandel - "Bubble Gum"
Like Saturn - "edge of reality"
Lil Playah - "Back in My ZONE!"
Lil Toe - "Skeletons in My Closet"
Madlib - "Dirtknock"
Mario Judah - "I Cannot Love You"
MAX - "Blueberry Eyes (Remix)" ft. Lil Mosey, SUGA & Olivia O'Brien
Miss Li - "Sorry"
MOL$ - "TOO COLD"
Pentatonix - "The Lucky Ones"
Pi'erre Bourne & Frazier Trill - "Missing"
PRETTYMUCH - "Stars"
R3HAB & Marnik - "Candyman"
Rachel Chinouriri - "Darker Place"
Raissa - "SHADES ON"
RHODES, YOUNOTUS & Deepend - "Smile"
Rich the Kid, Flo Milli & Latto - "Nasty" ft. Rubi Rose
Sabrina Carpenter - "Skin"
SATURDAY - "Only You"
scarlxrd - "RED LIGHT"
Silk City & Ellie Goulding - "New Love" ft. Diplo & Mark Ronson
Slayyyter - "Troubled Paradise"
Tash Sultana - "Sweet & Dandy"
Tee Grizzley - "Gave That Back" ft. Baby Grizzley
The Alchemist - "Water Bed"
Tiagz - "Bonjour"
Toby Romeo, Felix Jaehn & FAULHABER - "Where the Lights Are Low"
TREASURE - "Beautiful (Anime Edit)"
Trez Bell - "No Fun"
Winona Oak - "Winter Rain"
Yameii Online - "Pandora"
YBN Nahmir - "Opp Stoppa (Remix)" ft. 21 Savage
Years & Years - "It's a Sin"
YNW Bortlen - "Iceee"
Yo Trane - "Stay Down"
YSB Tril - "Ain't the Same"
Yung Bleu - "Ghetto Love Birds"
1/23
King Krule - "Imagine by John Lennon"
Kodak Black - "Last Day In"
Snail's House - "Blitz"
1/25
347aidan & Kenny Beats - "IDWK"
916frosty - "on melancholy hill"
Bad Sounds - "Move Into Me" ft. Broods
Bree Runway - "ATM (Breemix)"
CJ - "Bop"
Deko - "Mythbusters"
Fabich - "Missing" ft. Liv Dawson
KT Tunstall & Alan Cumming - "Caledonia"
Lauren Weintraub - "She's Mine"
Lil Mosey - "Holy Water"
Nechie - "Like a Dream" ft. Lil Durk
serpentwithfeet - "Fellowship" ft. Lil Silva & Sampha

1/26
Ben Howard - "What a Day"
Charlie Hickey - "Ten Feet Tall" ft. Phoebe Bridgers
Do Nothing - "Uber Alles"
FKA twigs - "Don't Judge Me" ft. Headie One & Fred again..
Half Waif - "Orange Blossoms"
IZ*ONE - "D-D-Dance"
SAFE - "Rumors"
Steven Wilson - "Man of the People"
Yuno - "Somebody"
1/27
A Day to Remember - "Everything We Need"
Alexander 23 - "Cry Over Boys"
Arlo Parks - "Hope"
BarbWalters - "Casino"
Bri Steves - "ANTI QUEEN"
Dizzy Wright - "Sexy Lady"
IU - "Celebrity"
Jaah SLT - "2021 Banger"
MICHELLE - "FYO"
Morcheeba - "Sounds of Blue"
Pink Sweat$ - "At My Worst (Remix)" ft. Kehlani
Porter Robinson - "Look at the Sky"
Skegss - "Valhalla"
Slimelife Shawty - "Homicide"
The Rubens - "Muddy Evil Pain"
Tom Aspaul - "The Program" ft. Funk LeBlanc & Madeleine Wood
Trapboy Freddy - "Hypocrite"
Tune-Yards - "hold yourself."
Unlike Pluto - "Sabotage"
Xiu Xiu - "A Bottle of Rum"
YONAKA - "Seize the Power"
1/28
Billie Marten - "Garden of Eden"
Blu DeTiger - "Vintage"
Brent Faiyaz - "Gravity" ft. DJ Dahi & Tyler, the Creator
Caleborate - "What U Want"
Chelsea Wolfe & Emma Ruth Rundle - "Anhedonia"
Dizzy Wright - "Sexy Lady"
Fredo - "Money Talks" ft. Dave
hololive IDOL PROJECT - "Suspect"
Hyuna - "Good Girl"
King Gizzard and the Lizard Wizard - "O.N.E."
Joshua Bassett - "Only a Matter of Time"
Liza - "Rolla"
Meek Mill, Leslie Grace & Boi-1da - "Conga"
Ocean Wisdom - "Uneven Lives" ft. Maverick Sabre
Teejayx6 - "Forgot My Bars"
Voda Fuji - "Head First"
WESTSIDE BOOGIE - "Joe Exotic (Freestyle)"
Yxng Bane - "Dancing on Ice" ft. Nafe Smallz & M Huncho

1/29
Alan Walker & ISÁK - "Sorry"
Anitta - "LOCO"
AViVA - "ANTIHERO"
Bailey Zimmerman - "Never Comin' Home"
B Young - "Ride for Me"
Babyface Ray - "If You Know You Know" ft. Moneybagg Yo
Bankroll Freddie - "Add It Up"
benny blanco, Marshmello & Vance Joy - "You"
Boys World - "Wingman"
Cavetown - "Sharpener's Calling Me Again" ft. Kina
Clean Bandit - "Higher" ft. iann dior
Emlyn - "a thousand parties"
Eric Bellinger & Hitmaka - "Only You"
Futuristic & Michael Minelli - "Gone"
G Perico & 1TakeJay - "Pull It"
iris - "voodoo voodoo" ft. SKAAR
Isac Elliot - "Waving at Cars"
James Reid & CARELESS - "Soda"
James Smith - "My Oh My"
JoJo - "American Mood"
JPEGMAFIA - "FIX URSELF!"
Julia Stone - "We All Have" ft. Matt Berninger
Kayzo & Black Tiger Sex Machine - "Lifeline" ft. Point North
Kxllswxtch & Pouya - "Lord of the Flies"
Lauren Cimorelli - "8am"
LBS Kee'vin & FCG Heem - "Hood Dreams"
Like Saturn - "cuddled up"
lil ricefield, Seiji Oda & Guapdad 4000 - "Anime Shawty, Vol. 2"
LocateEmilio - "Pressure"
Loser - "333"
Mat Kearney - "Powerless"
Max B - "Bad to tha Bone" ft. Giggs
Mike Posner - "Momma Always Told Me" ft. Yung Bae & Stanaj
Mike Williams & Jonas Aden - "I Hope You Know"
Muwop - "Built Like That"
N.O.R.E. - "Goin Up" ft. DJ Khaled & DreamDoll
N.O.R.E. - "Outta Line" ft. Conway the Machine & Method Man
Nasty Cherry - "Lucky"
Njomza - "Lucky (Live)"
Now United - "All Around The World"
O.T. Genasis - "Big League"
Pale Waves - "You Don't Own Me"
R3HAB, Rakhim & Smokepurpp - "Fendi"
Rag'n'Bone Man - "All You Ever Wanted"
Rat City & Dagny - "Bad"
Rebecca Black - "Girlfriend"
Sarcastic Sounds, Claire Rosinkranz & Clinton Kane - "change ur mind"
Sam Feldt - "Stronger" ft. Kesha
Savage Ga$p - "i'm drunk and i miss you still" ft. 1nonly & lilbubblegum
Sa Vich - ''Planet Earth 3.0' (Remix)' ft. Lil Fletcher & A P Capone
scarlxrd - "EVIL EGX"
Selena Gomez & Rauw Alejandro - "Baila Conmigo"
Tes X & Mario Judah - "It's Time to Rock"
Tokyo Jetz & T.I. - "Know the Rules"
Ty Dolla $ign - "Spicy (Remix)" ft. Post Malone, Tyga, J Balvin & YG
Xan Griffin - "Narcissist (Fly Guy)"
Yameii Online - "Photon Shooter"
Yella Beezy - "STAR" ft. Erica Banks
Young Stoner Life, Yak Gotti & Sheck Wes - "GFU" ft. Yung Kayo

1/31
Matt Ox - "Turn Up a Notch"
Mori Calliope - "Off with Their Hands"1Embed